ответить: ответили ответит ответила ответить
наука: науке науки наук наука наукой науку
использовать: использовали использует используемое использую использована используйте используем используемых использовано используете использовала используя используй использовать используют
хороший: лучший лучшая хорошим хорошими хорошему наилучшего хороший хорошая хорош лучшего лучшим хороших лучше лучшие хороша хорошего лучших хорошие хорошей лучшее хорошее хорошем
принимать: принимая принимать принимает принимают принимающих принимаемых принимаете принимаешь
витамин: витамином витаминов витамины витаминах витаминами витамина витамин
автор: автора автор авторов авторы авторах
просмотр: просмотре просмотров просмотром просмотра просмотр
нужный: нужное нужна нужен нужны
здоровье: здоровья здоровье здоровью здоровьем
кость: костях кость кости костей костям
мышца: мышцы мышц мышцах мышца мышцам мышцу мышцами
зуб: зуб зубах зубы зубам зубами зуба зубов
кожа: кожу коже кожей кожи кожа
действие: действия действиями действиях действиям действие действии действию действием действий
солнце: солнцу солнце солнцем солнца
поддерживать: поддерживаем поддерживала поддерживать поддерживает поддерживающие поддерживал поддерживают
уровень: уровень уровнях уровни уровнем уровня уровне
продукт: продукта продукте продукты продукту продуктах продуктов продуктам продукт продуктами
богатый: богатые богаты богато богат
печень: печени печень
треска: трески треска
лосось: лосося лосось лососе
сливочный: сливочном
масло: маслами масло масле масел масла маслом
ежедневный: ежедневному ежедневного ежедневное ежедневной ежедневная ежедневный ежедневным ежедневными
доза: дозе дозу доза дозами дозах дозы
примерно: примерно
грамм: грамм граммов
селёдка: селедки
тунец: тунца тунец
ряд: ряд ряду ряде
исследование: исследования исследованию исследованиях исследование исследованием исследованиями исследовании исследованиям исследований
отмечаться: отмечается
человек: людей людьми человеке люди людях человеком человек человека людям человеку
пожилой: пожилом пожилым пожилые пожилых пожилой
недостаток: недостатках недостатка недостатки недостатку недостаток
симптом: симптомом симптомов симптомы симптомах симптомами симптомам симптом
дефицит: дефицита дефициты дефицит дефицитом
боль: болями боли боль болью болей
сустав: суставов сустава суставы суставах
плохо: плохо
заживать: заживают заживала заживающие
мелкий: мелкие мелких мелкую
повреждение: повреждений повреждение повреждением повреждения
проблема: проблем проблеме проблемами проблемой проблемы проблемах проблему проблемам проблема
волос: волосы волосу волосами волоса волос волосам волосах
ноготь: ногтях ногтями ногтя ноготь ногти
пить: пить пейте пьет пили пьют пил пила пью пьете
здоровый: здоровый здоровыми здоровых здоровые здоровом здоровая здорово здоровую здоровой здоровым здоровее здоровому здорового
питаться: питаться питаются питается
регулярно: регулярно
середина: середины середине
осень: осенью осень осени
весна: весной весны
свет: свете свету света свет светом
хватать: хватает хватать
время: времен времени времена время временем
добавка: добавкой добавка добавками добавки добавок добавкам
животный: животного животные животной
происхождение: происхождения
сложный: сложное сложнее сложным сложная сложной сложно сложные сложными сложны сложного сложный посложнее
получить: полученных получила полученные получил полученными полученной получены полученная получили получит получите получило получить
количество: количеству количеством количествах количество количестве количества
пища: пище пищу пища пищей пищи
возникать: возникающих возникающими возникать возникало возникают возникает
уточнить: уточнит уточнить
врач: врачей врача врачах врачами врачи врач врачам врачом врачу
делать: делаю делают делаем делает делала делать делаете делали
постоянно: постоянно
кальций: кальций кальция
фосфор: фосфор фосфора
лучше: лучше
ребёнок: ребенком ребенку детей детях ребенке детям детьми ребенка ребенок дети
вызвать: вызовет вызванные вызовут вызван вызвавшего вызвал вызваны вызвано вызвать вызвана вызвала вызванная
молоко: молока молоко молоком
младенец: младенцев младенцам младенец младенца
вскоре: вскоре
рождение: рождения рождению рождение рождении
большинство: большинства большинству большинством большинство большинстве
малыш: малыш малыши малыша малышам малышей малышу
дополнительный: дополнительном дополнительной дополнительным дополнительное дополнительный дополнительная дополнительную дополнительного дополнительных дополнительные
источник: источники источниками источниках источника источникам источником источников источник
мама: мама маме мамой мам мамы
ежедневно: ежедневно
возможность: возможностям возможность возможности возможностей
зависимость: зависимости зависимостей зависимость
возраст: возрасте возрастом возраст возрастам возраста возрасту возрастов
воз: воз
рекомендовать: рекомендуют рекомендуем рекомендовали рекомендуемые рекомендует рекомендовать рекомендую рекомендован
вид: вида вид видах виды видами видом виду видов виде
год: годам лет год годах годами годов года годом годы году
сутки: сутки
взрослый: взрослых взрослыми взрослые взрослому взрослом взрослым взрослый взрослой взрослого
сюда: сюда
входить: входили входи входит входят входящие входите
беременный: беременной беременные беременных беременным беременную
кормить: кормящие кормит кормите кормить кормил
женщина: женщину женщин женщиной женщине женщинами женщина женщинам женщины
риск: рисках риски риску рисков риск рисками риска риском
превышать: превышать превышает
выше: выше
приём: приема приему приемов приемы прием приеме приемом
большой: большой большому большое велика большого большом
накопление: накоплению накопление накопления
организм: организмах организм организме организма организмом организмы организму
привести: привести приведет привели привела приведут
остеопороз: остеопорозу остеопороза
почка: почек почками почки почках
сердце: сердца сердцу сердце сердцем
комплекс: комплексе комплексах комплексы комплекс
поливитамин: поливитаминов
отдельно: отдельно
считать: считать считавший считаете считают считали считает считавшие считайте считал считаю
равный: равной равно равным
обратиться: обратилась обратившись обратиться обратился
терапевт: терапевта терапевту терапевт терапевтом
индивидуально: индивидуально
статья: статьях статью статьи статьям статья статьями статьей статье
понятно: понятно
непонятный: непонятно
комментарий: комментарий комментариях комментарии
войти: вошел войти войдите вошла
кабинет: кабинете кабинет кабинета
выбор: выборов выбор выбором выборе
редакция: редакция редакции
жизнь: жизнь жизни жизнью
питание: питанием питании питанию питания питание
внутренний: внутренних внутренней внутреннее внутренние внутренний внутреннего
дезодорант: дезодорант дезодоранты дезодорантов
запах: запаха запахом запахи запаху запах запахам запахов запахе
тело: телу тело теле тела тел телом телах
кишечник: кишечнику кишечнике кишечника кишечник
живой: живая живым живые живой
мёртвый: мертвая
вода: воду вода воде воды водой
правда: правдой правду правда
существовать: существовали существующие существуют существующей существующими существующую существует
еженедельный: еженедельная
важный: важные важна важный важен важно важная важных важную важным важное важны важнее важной важного
письмо: письме письмом писем письмо
поле: поле полем поля
заполнить: заполнить заполнил заполнено
подписать: подписаны подпишите подписано
подписываться: подписывайтесь подписываясь подписывайся
соглашаться: соглашаешься соглашается соглашаетесь
передача: передачи передачу передаче
персональный: персональный персональным персональные персональному персональных персональными
медиа: медиа
качество: качества качество качеством качеству качестве
факт: фактом факты факта факт фактов фактам
отвечать: отвечающую отвечает отвечайте отвечая отвечаем отвечать отвечают отвечали отвечающий
вопрос: вопросам вопросом вопроса вопросы вопросами вопросах вопросов вопросе вопрос вопросу
читатель: читателей читателям читатели
научный: научной научные научном научным научную научное научно научными научного научный научных
точка: точек точки точку точками точка
зрение: зрением зрение зрения
разбор: разбора разборы разборах разбор
блог: блогов блоги блог блогах блога
ментальный: ментальные ментальными ментальная ментальное ментального ментальную ментальному
справочник: справочник справочнике
подкаст: подкасте подкастом подкаст подкаста подкастов подкасты
дзен: дзен
тик: тик
ток: тока ток
проект: проекте проекты проект проекту проекта проектов проектом
политик: политику политика
конфиденциальность: конфиденциальности конфиденциальность
медицина: медициной медицины медицину медицине медицина
использование: использования использованием использовании использованию использование
материал: материалах материал материалов материалу материалами материалам материала материалы материале
разрешить: разрешено
согласие: согласия согласие
перейти: перейдя перейти перейдите
контент: контенту контент контенте контента
карта: картами карты картах карту карт карте карта
справка: справки справка
центр: центрах центра центру центров центре центр
сообщество: сообщества сообщество сообществе
политика: политику политика политикой политики
условие: условия условии условиях условиями условий
услуга: услугах услугу услуга услуг услуги
отправить: отправить отправила отправят
отзыв: отзывом отзывами отзывах отзыв отзыва отзывов отзывы
тема: темы темой теме тема тему
информация: информацию информации информацией информация
текущий: текущей текущем текущим
раздел: разделе раздела раздел
общий: общими общему общий общего общее общие общей общем общим общая общих
впечатление: впечатление впечатлениях впечатления
правило: правилами правил правилу правилам правилах правило правила
сведение: сведений сведения
тёмный: темная темного темные тёмную темными темной темную темнее
поиск: поиске поиска поисках поиск
очистить: очистит очистить очистите
приложение: приложении приложения приложением приложений приложение
главный: главное главный главным главную главными главной главного главных главная главные
меню: меню
спорт: спорте спортом спорт спорта
фитнес: фитнес фитнесом
календарь: календарю календаре календаря календарь
редактор: редакторы редактор редактором
цикл: цикл циклу цикле циклом циклы цикла циклов
влиять: влияла влияя влияющих влияют влияющий влиять влияющие влияет влиял
физический: физическом физической физический физическое физическому физическими физические физического физических физическая физическую физическим
сила: силе силы силами сил сила силой силу силах силам
успех: успех успехами успехов успехом
удивление: удивление удивлении
разобраться: разберемся разобраться разобрались
фон: фона фон фоне
меняться: меняется меняться менялось меняются
разный: разный разную разные разной разным разного разная разных разными разное
система: систему системы системе система систем системой
сосудистый: сосудистых сосудистыми сосудистого сосудистые сосудистую сосудистым сосудистой сосудистое
физиология: физиологию физиологии
упражнение: упражнений упражнение упражнения
разделить: разделить разделили
последовательный: последовательные последовательный
этап: этапах этапе этапу этапы этапа этапов этап
цель: целью целям целях целей цель цели
выпустить: выпустил выпустить выпустила
труба: трубы трубах трубам трубу трубе
яйцеклетка: яйцеклетка яйцеклеткой яйцеклетку яйцеклетки яйцеклеток
задумка: задумке
встретиться: встретилось встретиться встретилась встретились
дальнейший: дальнейшему дальнейших дальнейшего дальнейшей дальнейшими дальнейшие
развитие: развитию развитии развитием развитие развития
эпителий: эпителий
начинаться: начинаются начинаться начинается
конец: концу концов конец конца концы конце
кончаться: кончается
начало: началу началом начало
объяснять: объяснять объясняют объясняет объясняя объясняем
процесс: процессу процессами процессом процессе процессы процесса процесс процессах
кратко: кратко
четыре: четыре четырех четырем
основной: основные основной
фаза: фазах фазы фазой фазу фазе фаз фаза
выход: выход выходе выхода выходом
менструация: менструациях менструации менструация менструацию менструаций
активность: активность активности активностью
рассказывать: рассказывать рассказывали рассказывающий рассказываем рассказывают рассказывает
влияние: влияния влияние влиянием влиянии
результат: результатам результатах результаты результат результате результата результатом результатами результатов результату
анаэробный: анаэробные
показатель: показатель показателей показателями показатели
существенно: существенно
тренировка: тренировками тренировки тренировках тренировка тренировкой тренировку тренировкам тренировок
трудный: труднее трудного трудными трудным трудные трудно
отрицать: отрицать отрицают
изменять: изменяют изменять изменяет
настроение: настроении настроения настроение настроением настроению
момент: момент момента моментом моментов моменты
каждый: каждого каждую каждым каждом каждой каждому
день: днем дней днями дни дня день
происходить: происходящее происходящего происходило происходит происходят происходить
два: двум два двумя две двух
яичник: яичника яичники яичников
гормон: гормоны гормонов гормона гормон гормону
расти: растет росли растущее растут расти рос
будущий: будущая будущего будущем будущей будущие будущему будущую будущих
начать: начнут начнем начать начали начнет начал
вырабатывать: вырабатываем вырабатывают вырабатывать вырабатывает
эстроген: эстроген эстрогена эстрогенов
подготовка: подготовки подготовка подготовкой подготовку подготовке
следующий: следующих следующим следующем следующий следующими следующего следующее следующей следующие
возможный: возможной возможных возможные возможном возможного возможную возможна возможный возможному возможное
беременность: беременностью беременность беременностей беременности
низкий: низкой низким низкий низкого низкая низкие низкими низком низкое низкому низкую
повышаться: повышается
постепенно: постепенно
оживать: оживаешь
сворачивать: сворачивать
гора: горы горам горе гор
число: числом число числу числе числа
повышение: повышения повышению повышении повышение
мозг: мозгу мозге мозг мозга
нейромедиатор: нейромедиаторы нейромедиатор
дофамин: дофамин дофамина
серотонин: серотонин серотонина
результативность: результативность результативности
невысокий: невысокая невысокой
выходить: выходили выходящая выходя выхожу выходить выходит выходят
путешествие: путешествиях путешествие путешествия путешествием
выйти: вышел вышло выйдет выйти выйдут вышла выйдите
резкий: резкое резкий резкой резкому резкая резким
всплеск: всплеск
пик: пика пик
появляться: появляется появляться появляются
новый: новыми новому новом нового новым новейших новая новую новый новой новых новое новые
внимание: внимания внимание
подготовиться: подготовиться
снижаться: снижаться снижается снижался
первый: первым первыми первого первая первой первую первый первые первом первых первое
план: планы план плана плане планах планов
чувствовать: чувствовали чувствуют чувствовала чувствуешь чувствующая чувствую чувствуете чувствует чувствуем чувствовать
энергичный: энергичными энергичным
период: периоде период периоды
желание: желанием желаниях желании желанию желания желание
увеличить: увеличат увеличить
сексуальный: сексуальным сексуальный сексуальная сексуальной сексуальные сексуальных сексуальную сексуальному сексуальном сексуального сексуальное сексуальными
помогать: помогают помогаем помогали помогая помогать помогал помогало помогающие помогает
восстановить: восстановить
запас: запасы запас запасов
гликоген: гликогена
занятие: занятии занятиях занятиями занятиям занятием занятий занятия
защищать: защищает защищают защищать
мышечный: мышечной мышечную мышечных мышечные мышечный мышечного
ткань: ткани ткань тканях тканей
слой: слоях слоя слоев слои слоем слой
матка: матки матка матку
сосуд: сосуда сосуды сосудов
железа: железе железы железой желез железа
секреция: секреции
остальной: остальной
готовиться: готовиться готовились готовится
изменение: изменением изменении изменение изменений изменениях изменению изменениями изменения
ответственный: ответственным ответственного ответственных ответственны ответственен
достигать: достигать достигает достигала
наступать: наступает
потребность: потребность потребности потребностях потребностью потребностей
отдых: отдыхе отдыха отдых
спокойствие: спокойствии спокойствие спокойствия
усталость: усталости усталостью усталость
задержка: задержке задержки задержкой задержку задержка
жидкость: жидкостями жидкостях жидкость жидкости жидкостей жидкостью
проявление: проявления проявлений проявление
синдром: синдроме синдрома синдромом синдром
оплодотворение: оплодотворение оплодотворения
произойти: произойдет произошедшее произошла произошло произошли произойти произошел
чувство: чувством чувств чувствами чувствам чувство чувства
энергия: энергию энергия энергией энергии
снижение: снижении снижению снижение снижением снижения
выработка: выработки выработка выработке выработку
длительность: длительность длительностью
изучить: изучили изучить изучен изучена изучены изучено
помочь: помогли помогите помогут помогло поможем помочь поможет помогла
спазма: спазмах
исследователь: исследователи исследователей
обнаружить: обнаружить обнаружили обнаружил обнаружен
болезненный: болезненным болезненных болезненные болезненной болезненная болезненный
спазм: спазмов спазмы спазма спазм
заниматься: занимаемся заниматься занимающийся занимаются занимающихся занимался занимается занимались
обычный: обычного обычным обычном обычной обычную обычное обычными обычных обычная обычному обычные обычный
ходьба: ходьба ходьбы
чрезмерный: чрезмерная чрезмерные чрезмерный чрезмерных чрезмерной чрезмерное чрезмерного
полный: полное полную полными полного полные полный полному полном
прекращение: прекращение прекращения прекращении прекращению
встречаться: встречаются встречается встречаться встречающаяся
тренироваться: тренироваться тренируются
обращаться: обращайтесь обращаться обращался обращается обращаются обращались
менопауза: менопаузу менопауза менопаузы
масса: массе масс массой массу массы
нижний: нижним нижними нижние нижнем нижнее нижней
часть: частью частям части часть частей
оставаться: оставаться остается остаются остающаяся
активный: активная активный активными активные активной активных активны активен активным активное
оральный: оральном оральных оральный оральные оральным
снижать: снижает снижать снижают снижали
играть: играть играют играл играли играет
роль: роли роль
увеличение: увеличению увеличении увеличения увеличение
небольшой: небольшого небольшому небольшие невелик небольшом небольшой небольшое небольшими небольшим небольших
производительность: производительности
разница: разницы разница разнице
незначительный: незначительный незначительно незначительная
решение: решения решению решений решение
средство: средством средства средству средств средство средствах средствам средствами
говорить: говорю говорят говорили говорила говорит говорить говорите говорим говоря говорил
защита: защиты защиту защита защите
травма: травму травмах травме травмы травма травмам травмами травм
стабилизация: стабилизации
уменьшение: уменьшении уменьшения уменьшение уменьшению
колебание: колебаний
резюме: резюме
сегодня: сегодня
предполагать: предполагают предполагаем предполагаемой предполагает
наличие: наличие наличии
связь: связи связей связь
составление: составлении составления
прислушиваться: прислушиваться
провести: проведено проведен провели провести провел проведенное проведет проведенных
полностью: полностью
пропускать: пропускать пропускает пропускаю
стоить: стою стоящий стоит стоящее стоишь стоя
подумать: подумать подумайте
лёгкий: легком лёгкой легким легкие легкий легких легкой легкого легкую легкими легкая лёгкий легче легко легкое
понять: понять поймет поняла поняв поймут понял
тип: типом типы типе типу типов типах типа типами тип
подходить: подходящий подходящую подходящего подходит подходить подходящих подходящее подходящие подходят
течение: течение
месяц: месяца месяцам месяце месяцев месяц месяцы
читать: читайте читать читаешь читают читали читала читаете читал
пропасть: пропасть пропали пропал пропала
стресс: стрессом стресс стресса стрессу стрессе
вернуться: вернусь вернулась вернется вернутся вернуться
тошнить: тошнит
понятный: понятны понятным понятнее понятно
феномен: феномена феномен
выделение: выделениями выделений выделения выделению
влагалище: влагалища влагалище
нормальный: нормальному нормальный нормальных нормальные нормальными нормальная нормальной нормальную нормально нормальным нормальны нормальное
деликатный: деликатный
ругать: ругать ругала ругают ругали
мастурбация: мастурбации мастурбацией мастурбацию мастурбаций мастурбация
половой: половые половую половым половыми половом половой половому половых половая полового половое
воспитание: воспитание воспитания воспитанием воспитании воспитанию
родитель: родителем родителям родителей родителя родитель родителю родители родителями
игнорировать: игнорируют игнорировать
стараться: стараться старался старалась старайтесь старается стараюсь стараются
вместе: вместе
медицинский: медицинским медицинская медицинские медицинскую медицинских медицинского медицинской медицинское медицинском медицинский
становиться: становиться становится становлюсь становятся
секс: сексе секс сексом сексу секса
поднимать: поднимающая поднимает поднимать поднимают поднимали
папа: папа папы
рассуждать: рассуждать рассуждают
лекция: лекций лекции лекцию
вырасти: вырастет выросли вырос выросла
контролировать: контролирующие контролируют контролируем контролирующее контролируемым контролируемые контролирующих контролировать контролирующий контролирует
насколько: насколько
адекватный: адекватное адекватную
обучаться: обучаться
порно: порно
история: историям историями истории историю историей история историй
старший: старший старшим старше старшему постарше старших старшего
друг: другом друзья друзьями другу друг друзьям друзей
практика: практика практику практиках практик практикам практикой практике практики
опасный: опасным опасен опасны опасной опасная опасно опасных опасные опасного опасна опасными
понимать: понимаю понимать понимала понимаем понимающих понимали понимаете понимая понимает понимают
степень: степенью степени степень
интересовать: интересуют интересующей интересует интересовала
небо: небо
голубой: голубого голубое голубой
браться: берется берутся
мир: миры миром миру мира мир мире
взросление: взрослении взросления взросление
разговор: разговорам разговоры разговорах разговор разговоре разговоров разговором разговора
знать: знаете знали знает знаешь зная знайте знал знаем знаю знала знать знают
поведение: поведению поведении поведения поведением поведение
трогать: трогали трогают трогал трогать трогает
гениталии: гениталии
зажимать: зажимает зажимаю зажимают
одеяло: одеяло одеяла одеялом одеял
нога: ногам ногой ногами ноге ногу ног нога ноги ногах
смотреть: смотрели смотрят смотрит смотрю смотреть смотрите смотрим смотря смотришь
мультик: мультики
снимать: снимают снимали снимал снимает снимать
штаны: штаны
доктор: доктор доктора доктору
пугать: пугающие пугают пугает пугающих пугала пугать
смущать: смущать смущающей смущает
означать: означают означать означает
бушевать: бушуют бушует
стадия: стадии стадий стадию стадиях
формирование: формирования формированию формирование
самосознание: самосознания
полтора: полутора полтора
воспринимать: воспринимает воспринимают воспринимать
постоянный: постоянному постоянные постоянное постоянный постоянного постоянных постоянная постоянной
контакт: контакта контакт контактов контактом контактами контакты контакте
осознавать: осознавать осознает
исследовать: исследует исследовать исследованы исследуют
ощущение: ощущений ощущениях ощущения ощущениям ощущением ощущение
уметь: умел умею умеет уметь умеют
внешность: внешности внешность внешностью
признак: признаках признакам признаками признак признаков признаком признаки
пол: полу полом пола полы пол
относиться: относится относитесь относящийся относились относятся относиться относящаяся относимся
показывать: показывайте показывали показываем показывать показывает показывают показываете
орган: орган органа органах органам органов органом органы
мастурбировать: мастурбировать мастурбируют мастурбирует
естественный: естественных естественное естественная естественного естественном естественным естественный естественной естественные
становление: становление
гендерный: гендерные
вести: ведет вела вести вели ведут ведущей веду ведете
соответствие: соответствия соответствии соответствий соответствие
девочка: девочка девочек девочки девочку девочке девочкам девочками девочках
аккуратный: аккуратными аккуратной аккуратным
скромный: скромному скромными
мальчик: мальчику мальчика мальчикам мальчиками мальчики мальчиков
сильный: сильного сильна сильнее сильную сильными сильное сильном сильный сильная силен сильные сильной
серьёзный: серьезной серьезное серьезного серьезную серьезная серьезных серьезный серьезные серьезным серьезными
зависеть: зависеть зависит зависят зависело
отношение: отношений отношениями отношения отношение отношению отношении отношениях отношениям
семья: семей семья семьям семьях семьи семье семьей семью
окружение: окружения
социальный: социальным социальный социально социальной социальную социальными социальное социальных социального социальном социальные социальная
культурный: культурных культурном культурная культурными
фактор: факторы фактором факторами факторах факторе факторов фактор фактора
влечение: влечение влечения влечении влечению
разделять: разделять разделяют
три: трех три тремя
проводить: проводимые проводила проводите проводить проводит проводят проводили
фантазия: фантазиями фантазиях фантазии
развиваться: развиваться развиваются развивается развивающихся
пройти: прошедшее прошедшие пройду прошедший прошла прошел прошли пройдет пройти
ругаться: ругаются ругаться
запрещать: запрещать запрещаем запрещают запрещал запрещает
прикасаться: прикасаться
хотеть: хотите хочет хотели хотим хотят
получаться: получается получалось
интимный: интимный интимное интимной интимную интимных интимные интимном
ранний: ранние ранний ранним раннего ранняя раннем ранних
эксперимент: эксперименты экспериментов эксперимент эксперимента экспериментах экспериментам эксперименте
пятёрка: пятеркой пятерку пятерки
страна: стран странам страна страны стране странах страну
аборт: абортов аборта
подросток: подростка подростком подросток подростков подросткам подростками подростки
беременеть: беременеть беременеет беременеют
девушка: девушка девушками девушки девушек девушкой
учить: учат учит учить
название: названием названий название названиями названию названиях названиям названия
приемлемый: приемлемую приемлемы приемлемого
непрерывный: непрерывный непрерывной
пойти: пошла пойду пошел пойти пойдет пошло
школа: школа школу школы школе
книжка: книжки
ситуация: ситуациях ситуация ситуации ситуацию ситуаций ситуацией
решать: решать решает решают
бить: бьют бьет бить
рука: руках руке рукой рук руку руки руками рукам
пенис: пенисе пенис пениса пенисом
учитывать: учитывает учитывать учитывая
сценарий: сценария сценарий сценарии
беспрекословно: беспрекословно
следовать: следовал следуют следовать следуйте
слово: слово словам слова слове словах словами слову словом слов
запрет: запрет запреты запретам запретом
сказать: сказали скажем сказал сказала сказать скажите сказано скажет
одинаково: одинаково
грязный: грязно грязное грязные грязном грязная
противный: противно противного
связывать: связывают связывать
удовольствие: удовольствий удовольствия удовольствие удовольствием
стыд: стыдом стыда стыд
наказание: наказание наказанием
невозможность: невозможность
достигнуть: достиг достичь достигших достигнуть
оргазм: оргазмы оргазмов оргазму оргазмом оргазм оргазма
испытывать: испытываю испытывают испытывает испытывать испытывали испытывающего испытываете
вина: вина вину вины
наслаждаться: наслаждайтесь наслаждается наслаждались наслаждаться
детство: детства детство детстве
ёрзать: ерзать
стул: стуле стулья стул стульев
бабушка: бабушке бабушка бабушки
увидеть: увидите увидеть увидели увидела
сон: снов сну сны сном сна сон
купить: купить купил купленной купят купила
подарок: подарков подарком подарка подарок подарки подарками
перестать: перестать перестали перестал перестала перестанет
научиться: научились научиться научилась
видеть: видите видели видел видят видишь видеть видела вижу видим видит
ждать: жду ждала ждем ждать ждут ждет
засесть: засядет
телевизор: телевизором телевизор телевизора
уйти: уйти ушедшим ушла ушел уйдут ушедшего уйдет
готовить: готовит готовили готовить
любить: люблю любящих любила любят любите любим любит любимый любить
засыпать: засыпала засыпают
вариант: варианты вариант вариантом вариантов
душа: душе души
стучаться: стучалась
открыть: открыто открыты открыт открыла открытом открыли открыть
струя: струя струей
быстро: быстро
классный: классная классные классно классных классного классным
лишиться: лишилась
неприятный: неприятно неприятными неприятных неприятный неприятной неприятного неприятные неприятным
больно: больно
думать: думаете думала думают думаю думать думайте думает думаешь
раз: раз разы раза
оказаться: окажется оказались оказался оказалось оказаться оказалась
право: права правом право прав
особый: особой особый особых особого особое
убегать: убегала
душ: душа душ
предлог: предлогом
помыться: помыться
менять: меняла менять меняли меняем меняет
партнёр: партнерам партнеру партнере партнеров партнер партнёров партнера партнером партнеры партнерами
верный: верно верны верна верный верными
способ: способ способы способом способов способа способах
научить: научен научить научит научила научите научат
конкретный: конкретный конкретными конкретную конкретному конкретнее конкретным конкретных конкретной конкретного
прибегать: прибегает прибегать
идеал: идеалом идеале идеалами идеалы
заметить: заметить заметили заметила заметят
место: мест местах местами месту месте место места
рассказать: рассказать расскажут расскажет рассказала рассказал расскажите расскажем рассказали
гигиена: гигиены гигиена гигиеной гигиену гигиене
объяснить: объяснили объяснить объяснила объясните
стать: статей станет станут
остаться: остаться остались останутся оставшиеся остался оставшаяся осталось осталась останется
комната: комнате комнаты комнату
тихий: тихом
час: часе часами часа часов часах часы час часу
заснуть: заснуть
резко: резко
подойти: подойдите подойдет подойти подошла подойдут подошел
выдернуть: выдернула
кричать: кричит кричат кричать
сякой: сякой
стыдно: стыдно
прятаться: прятаться прячется
посмотреть: посмотрела посмотрят посмотрите посмотрели посмотреть
проснуться: проснулся проснулись
трус: трусы трусами трусов
смеяться: смеяться смеется
тыкать: тыкать
палец: пальцах пальцы пальце пальцами пальцем пальца
дело: делами дело делом делам дел деле дела делах
телосложение: телосложение
погрузиться: погрузиться погрузилась
связать: связанных связаны связанное связанными связано связана связан связанные связанную связанного связанный
сад: саду сада
неправильный: неправильная неправильной неправильном неправильным неправильного неправильные
тревога: тревогу тревога тревогой тревоги тревоге
появиться: появиться появилась появились появилось появятся появившийся появился появится
напряжение: напряжение
опускать: опускает
нервничать: нервничать нервничает нервничала
плакать: плакать плачут плачет
убирать: убирать убирают убирает
неочевидный: неочевидных неочевидными
иметь: имели имеем имея имеют имейте имеющими имеющих
родиться: родилась родился родиться
младший: младший младшего младшем младшей младшая младшими
сестра: сестра сестрой
член: членов членом член члена члену членами
слышать: слышит слышать слышу слышали слышим слышал слышала
бережно: бережно
хрупкий: хрупкого хрупкие
подрасти: подросла подрастет
измениться: изменится измениться изменилось изменился изменилась
царапина: царапины
коленка: коленки коленках
заноза: занозы занозу
синяк: синяки
игра: игрой игры игр игру игре игра
улица: улице улиц улицу улицы
избегать: избегайте избегают избегать избегаете избегает избегая
девчонка: девчонок девчонки девчонка
волейбол: волейбол
парень: парням парнем парней парня парни парню
акт: акт акты актов актом акта актами
поздно: поздно
кончить: кончил
партнёрша: партнершу партнерши
решить: решите решил решить решила решит решили
нерв: нерв нерву нервов нервы нерва
периодически: периодически
вставать: встает
кончать: кончаю
долгий: долгое долгие долгую долгим долгий долгого
находить: находите находим находит находил находят находить
устать: устать уставшим устал
полгода: полгода
собраться: собрались собрался собралось
сдать: сдать сдал
анализ: анализом анализу анализы анализах анализа анализе анализ анализов
сходить: сходила сходить сходил сходит
найти: найти найдете нашла нашел нашли найдите найденных
посоветовать: посоветовала посоветовал посоветовать
похожий: похожим похожи похожее похоже похож похожая похожие похожего похожими похожей
образ: образов образа образ образе образы образом образу
мужчина: мужчине мужчину мужчины мужчин мужчина мужчинам
полигамный: полигамны
жена: жены жене женами женам жена
муж: мужья мужа мужем муж
любовница: любовницу
удержать: удержать
возникнуть: возникнуть возникшую возник возникла возникнет возникшем возникли
диспареуния: диспареуния
болезнь: болезней болезням болезнях болезнью болезнь болезни болезнями
инфекция: инфекция инфекций инфекциями инфекции инфекцией инфекцию
страх: страхами страхом страху страха страхах страх страхе страхов страхи
пора: порой поры
пытаться: пытались пытается пытаюсь пытайтесь пытаются пытаться пыталась
уберечь: уберечь
обнимать: обнимают
наедине: наедине
сделать: сделает сделанных сделать сделано сделало сделали сделала сделан сделают сделаем сделайте сделал
бояться: боятся бойтесь боясь боимся боялись боюсь боится бояться
обсуждать: обсуждают обсуждать обсуждал обсуждала обсуждает
прийти: пришла пришел придет пришло прийти пришли придут
улучшение: улучшения улучшение
дать: дала даст дайте дали дал дать дало
домашний: домашние домашнее домашняя домашних домашний домашнего
задание: задание заданиями задания заданием
описать: описал описано описала описать
написать: напишите написали написала написал напишет написать написанные написав написано написанный
итог: итоге итог итоги
пустой: пустым пустые пустую пустых пустая
лист: листьев листья листьями листом
признаться: признался признаться призналась
честно: честно
уважать: уважают уважает
сторона: сторону стороны сторон стороне сторонам сторона стороной
помнить: помните помнить помню помнит
старичок: старичка
максимум: максимум
тактильный: тактильного тактильный
ручка: ручки ручка
праздник: праздникам праздника праздников праздники праздником праздник
темнота: темноте
поза: позе позу поза позы позах
неуместный: неуместной неуместными
надеяться: надеюсь надеются надеемся
какой: какое какую каком каких
демонстрация: демонстрация
нежность: нежность
интонация: интонаций интонация
окружать: окружающая окружающей окружают окружает окружающие
анатомия: анатомии анатомия
неловкость: неловкость неловкости
пересказ: пересказ
домогательство: домогательства домогательствах домогательств
манипулировать: манипулировать
узнавать: узнают узнавать
выгнать: выгонят выгонит
дом: дом домах дома домом доме
донести: донести
правильный: правильной правильнее правильную правильный правильному правильном правильные правильно правильная правильных правильного правильным
грамотный: грамотные грамотный
готовый: готовы готов готовые готовыми готовой готового готовым готовый готовая готова готово
ответ: ответов ответом ответу ответам ответа ответах ответ ответы
книга: книги книгой книге книга книг книгу
поговорить: поговорим поговорить поговорили поговорите
буше: буше
пелёнка: пеленок
свидание: свидание свидания свиданий
учебник: учебниках учебникам учебнику
разбирать: разбирает разбирали разбираем разбирать
глава: главе глава главой главу
следить: следить следила следил слежу следят следи следим
интерес: интересе интереса интересы интерес интересом интересам интересами интересах интересов
спрашивать: спрашивать спрашивают спрашивает спрашивайте
узнать: узнать узнав узнала узнали
снять: сняли снимет снимите снять снятые снятая снятую
угол: углу углом
ходить: ходить ходил ходили ходят ходит ходите хожу
буква: буквами букву буквы
алфавит: алфавит
слог: слоги
строить: строить строят строит
будущее: будущего будущее будущем
курица: куриц курица курицу курицы
лапа: лапой
почерк: почерк
волшебный: волшебный волшебного волшебная волшебной волшебными волшебных волшебные
пилюля: пилюли
магний: магния магний
каприз: капризов
маленький: маленький маленькому маленьким маленькие маленькой мала маленьких мал маленькими маленькое маленького маленьком
рост: рост роста росту
диагноз: диагнозы диагнозом диагнозами диагноз
ир: ир
состояние: состояний состоянии состояниях состоянием состоянию состояния состояние состояниям
врождённый: врожденным врожденной врожденная врожденный врожденными
временной: временное временным временные временная
лекарство: лекарствах лекарство лекарствами лекарства лекарств лекарством
основа: основой основы основа основе основу
лежать: лежа лежит лежать лежащего
чувствительность: чувствительности чувствительность
клетка: клетками клетках клетки клеток клеткам
функция: функция функций функции функциях функцию функцией
состоять: состоит состоящего состоят
глюкоза: глюкозы глюкоза глюкозу
кровь: кровь кровью крови
расщепить: расщепить расщепленные
еда: еда еду еде еды едой
молекула: молекула молекул молекулы молекулу
доставить: доставить
очередь: очереди очередь
расходовать: расходуют
норма: нормы норм норме норма нормами нормам норму нормой
сигнал: сигналов сигналы сигналами сигнал сигнала
словно: словно
выбрасывать: выбрасывает
незаметный: незаметно
устойчивый: устойчивый устойчивой устойчивыми устойчивому устойчиво
следом: следом
сахарный: сахарного сахарной сахарным сахарном сахарному сахарный
второй: втором вторых вторая вторые вторым второй второму второго второе вторыми
первичный: первичной первично первичный первичная
событие: событиям событие событий события событием событиях
вторичный: вторичном вторичным вторичная вторичной вторичный
обусловить: обусловлена обусловленной обусловленного обусловлен
крайне: крайне
редкий: редких редкая редкие
устойчивость: устойчивость
редко: редко
выраженный: выраженные выраженной выраженно выраженную выраженная
подростковый: подростковому подростковых подростковом подростковыми
отсутствие: отсутствия отсутствие отсутствии отсутствием
потеря: потеря потерю потерей потерь потере потери
ожирение: ожирения ожирением ожирению ожирение
абдоминальный: абдоминальное
концентрироваться: концентрируется концентрироваться
область: области область областями областях областей
живот: животом живота живот животу животе
адреналин: адреналином адреналин адреналина
кортизол: кортизол
вызывать: вызывала вызывающим вызывают вызывающего вызывает вызывающее вызывать вызывающие
глюкокортикоид: глюкокортикоидов
терапия: терапией терапии терапия терапию
комбинированный: комбинированных
плацента: плацента плацентой
работа: работы работу работа работой работ работе работам
компенсировать: компенсировать
жаловаться: жалуются жаловаться жаловалась
свойственный: свойственные свойственно
жажда: жажда жаждой жажду
аппетит: аппетитом аппетита аппетит
мочеиспускание: мочеиспусканию мочеиспускание мочеиспускания мочеиспускании
головной: головном головного головную головной головная головные
частый: частая частых частое частыми частой частого частые
рана: рана раны ран
высокий: высокими высокой высокие высокая высшего высокое высока высокий высоки высшее высоком высшему высокого высоким высоких
вмешаться: вмешаться
правильно: правильно
подобрать: подобрать
рекомендация: рекомендациях рекомендаций рекомендацию рекомендация рекомендациям рекомендации
непросто: непросто
метод: методу метода методы метод методом методе методов методам
определение: определении определения определений определение
диагностика: диагностике диагностику диагностика диагностики
динамика: динамику
измерение: измерением измерение
гемоглобин: гемоглобин гемоглобина
последний: последнем последний последнего последние последней последнее последняя последним последними последних последнему
панель: панели панель
определять: определяющей определяющих определяют определяет определяющие
жир: жиров жир жиры жирами жира
холестерин: холестерин холестерина
косвенный: косвенная косвенный
находка: находки
определить: определенном определенные определят определить определенным определенных определили определенной
лечиться: лечиться лечится
лечение: лечению лечении лечение лечения лечением
пациент: пациенты пациентом пациенту пациентов пациент пациентами пациентах пациента пациентам
труд: трудом труда
изменить: изменить изменило изменена изменит
помощь: помощью помощи помощь
наладить: наладить
советовать: советует советовать советуют советовала
рацион: рациона рацион рационах рационе
медленный: медленные медленной
углевод: углеводов углеводы углеводами углеводах
простой: простым простыми попроще прост простых простое простоя простые простой
скачок: скачок скачка
действовать: действующим действующем действующего действующее действовать действующие действует действующему действуют
ровно: ровно
вес: весе весу вес весах весы веса
пешком: пешком
граница: границы границ граница границах границами
улучшать: улучшающие улучшать улучшает улучшающих улучшают улучшайте
причина: причинами причина причины причинах причиной причин причинам причину причине
подбирать: подбирает подбирают подбирать
родственник: родственником родственников родственниками родственники родственник
посещать: посещал посещает посещали посещают посещаете посещаемых посещать
сдавать: сдавать
подсластить: подсластить
хотеться: хотеться хочется
сладкий: сладкую сладкий сладкие сладкими сладкому сладкой сладкая сладким сладкое сладкого
грустный: грустная грустной грустную грустное грустно
тестостерон: тестостерону тестостерона тестостерон тестостероном
деформация: деформации деформация
психология: психологию психология психологии
мода: мода моде моду моды модой
красота: красоте красоты красотой красоту красота
культура: культуры культура культур культуре
новость: новостями новостей новость новостях новости
карьер: карьера
коллаборация: коллаборацию коллаборации коллабораций
выпуск: выпуском выпуск выпуске выпуски выпуска выпусков
индустрия: индустрию индустрии индустрия
тенденция: тенденции
съёмка: съемка съемке съемок съемкой съемки
макияж: макияж макияжем макияжа
уход: уход уходу уходе ухода
аромат: ароматов ароматах ароматами ароматам ароматом аромата ароматы аромат
кино: кино
журнал: журналах журнал журнала журналы журнале
музыка: музыка музыке музыки музыку музыкой
искусство: искусство искусства искусств
новогодний: новогоднем новогодние новогоднюю новогодних новогодним новогодней новогоднего новогодний
текст: тексту тексте текстов тексты текст текстом текста
неделя: неделя недели неделю недель неделе
ноябрь: ноябрь ноября ноябре
пахнуть: пахли пахнут пахнуть пахнет пахнувшие
исправить: исправить исправит исправят
дух: духи духов
шампанское: шампанское шампанского
мандарин: мандаринов мандарина мандарин
свеча: свечу свечей свеча свечи свече
дрова: дрова
наполнять: наполняющие наполняют
ярмарка: ярмарке ярмарки
достойный: достойной достойным достоин достойный
соперник: соперник соперников соперником
мамин: маминому
оливье: оливье
праздничный: праздничный праздничной праздничного праздничном
стол: столу столе столом стол столах
камин: камин камина
ёлочный: елочные
базар: базары базаре
открыться: открылись
уютный: уютных уютного уютной уютные уютная
вечер: вечером вечеров вечера вечеру вечер вечерами
тёплый: тепло теплой теплую теплое теплая теплым
согревать: согревающая
напиток: напиток напитки напитков напитка напитками напитком
зимний: зимними зимних зимним зимний зимней зимние зимнего зимнем зимнему зимнюю
ваниль: ваниль ванили ванилью
боб: бобов бобы
цитрус: цитрусов цитрусы
корпоратив: корпоративе корпоратив
флакон: флаконов флакон флаконе флаконах флакона
ананас: ананасы ананас
внутри: внутри
ароматный: ароматного ароматных ароматные ароматный
никакой: никакая никаких никакого никакие
бенгальский: бенгальские
огонь: огни огнем огонь огне огня
щепотка: щепотка щепотку
пряность: пряностями пряностей
чай: чае чаю чай чаем чая чаи чаев
специя: специи специями специй
внутрь: внутрь
употреблять: употребляют употребляющих употреблять употребляете
вбежать: вбежали
деревянный: деревянный
сруб: сруб
лес: лесу лес леса
согреться: согреться
выпить: выпили выпила выпить
стопка: стопку стопки
пряный: пряным пряный пряными пряного пряной пряных
настойка: настойки
кардамон: кардамон кардамоном кардамона
офис: офисе офис
порция: порцией порция порций порции
зажечь: зажжем зажечь
горячий: горячее горячий горячей горячая горячие горячим горячего
шоколад: шоколада шоколад
сохраняться: сохраняются сохраняется сохраняться
апельсин: апельсина апельсин
гвоздика: гвоздика гвоздики гвоздикой гвоздику
кориандр: кориандр кориандром
идеальный: идеальную идеальным идеально идеальных идеальный идеальном идеальная идеальное идеального идеальной
смесь: смесь смесью смеси
глинтвейн: глинтвейна глинтвейн
нота: нотами нот ноты
ароматический: ароматические ароматических ароматического ароматическая
информативный: информативным
чёрный: черные черном черная черного черный
согреть: согреет согреть
заодно: заодно
недостаточно: недостаточно
компания: компаниями компаниях компании компаниям компания
лайм: лайма
культовый: культового
радость: радостью радостях радость радости радостям
мнение: мнение мнению мнением мнения мнении мнений
подборка: подборки подборка подборке подборкой
объект: объект объекте объекта объектом объектам
прозрачный: прозрачным прозрачными прозрачный прозрачная прозрачные прозрачного
содержание: содержания содержание содержанию содержанием
тимьян: тимьян
кумин: кумин
сандал: сандал
плюс: плюсов плюс плюса
сладость: сладостей сладости сладость сладостях
окно: окном окна окно
вьюга: вьюга
втридорога: втридорога
скупать: скупали
бумага: бумаги бумага бумагой бумагу
принтер: принтере принтера принтером
спешить: спешили спешит спешат
приобрести: приобрести приобретет
клуб: клуба клуб клубах клубов
абсолютно: абсолютно
натуральный: натуральной натурального натуральный натуральную натуральных натуральная натуральные
дым: дыме дым дыма
почувствовать: почувствовать почувствовала
малина: малины
кедр: кедрами кедра
амбра: амбры
коробка: коробку коробки коробка
вкрапление: вкраплением
ноль: ноль
калория: калорий калории
доступный: доступнее доступен доступна доступно доступных доступным доступными
магазин: магазинах магазины магазине магазинам магазин магазинов магазина
реклама: рекламе рекламу реклама рекламы
канал: каналом канале канал каналов
мелодия: мелодией
интересный: интересное интересных интересные интересными поинтереснее интересным интереснее интересен интересно интересная интересный
бренд: бренда бренды брендом брендов бренд брендами
создавать: создавать создает создаете создающих создаёт создавая создают
художник: художник художников художники художника художниками
злой: зол злых
смена: смена смены смене сменой смену
вампир: вампиров вампиром
фига: фигу
фанат: фанатов фанат
ревизия: ревизию ревизия
инжир: инжир инжира
команда: команда команде командой
соглашение: соглашения соглашение соглашению
издание: издание
современный: современные современным современном современную современных современный современной современного современному современная
сайт: сайтах сайты сайтом сайт сайта сайте сайтов сайту
ссылка: ссылкам ссылкой ссылку ссылке ссылка ссылками ссылок ссылки
ресурс: ресурс ресурсов ресурсам ресурсами ресурсы ресурсе
принадлежать: принадлежит принадлежащие
деятельность: деятельность деятельности
запретить: запретить запрещено запрещенной запрещенного запрещена
верховный: верховным
суд: судах судом суда
международный: международные международным международной международного международный международном международных
движение: движений движением движение движения движении
разместить: размещенного разместить размещенную размещены
вступление: вступления
файл: файлы файлов
работать: работающих работающего работала работают работает работаете работаем работающей работать работаю работающие работал
против: против
пилинг: пилинги пилинга пилинг пилингу
улучшить: улучшить улучшите улучшат
внешний: внешних внешнего внешним внешние внешний
называть: называем называете называли называют называю называет называемую называйте называть называемой называла
клиника: клиника клинике клиник клинику клиниках клиники
направлять: направляет
интенсивный: интенсивной интенсивным интенсивные интенсивное интенсивную интенсивных интенсивный
луч: лучи луч лучей
разрушать: разрушают разрушает разрушаем
эпидермис: эпидермис
убрать: убрать
пятно: пятно пятен пятна
неровный: неровный
тон: тона тон тоном
текстура: текстура текстуру текстуры текстур текстуре
растяжка: растяжках растяжка растяжки растяжек
удалить: удалила удалите удалить удалены удаленного удалили удалив
глубина: глубину глубине глубиной глубины
шрам: шрамов
ветрянка: ветрянка ветрянке ветрянки
сыпь: сыпи сыпь сыпью
лазер: лазером лазеры лазера лазер
нагревать: нагревает
глубокий: глубокая глубокую глубоких глубокий глубокого глубокое глубокие глубокой глубже глубокими
дерма: дерму дермы дерме
коллаген: коллагеном коллагена коллаген
агрессивный: агрессивным агрессивная агрессивных агрессивное агрессивны агрессивными агрессивный агрессивные агрессивном агрессивного
применять: применяемые применяют применять применяет
косметика: косметике косметика косметикой косметику косметики
длина: длина длины длиной длину
волна: волн волны
абляционный: абляционный
повреждать: повреждает
дольше: дольше
эффект: эффектом эффекты эффектах эффект эффектам эффекту эффектами эффекта эффектов
грубый: грубый грубые грубой грубая грубыми
снизить: снижен снизить снижена
пигментация: пигментацию пигментацией пигментации пигментация
газ: газе газ газа
тонкий: тонкими тонкое тонком тонкого тонких тонкий тонкую
неглубокий: неглубокие неглубокую неглубоких
выбирать: выбирать выбирает выбираем выбирают выбираете выбирая выбирайте выбирала
лето: летом лето
совет: совет советов совета совете советы
хирург: хирургов хирургам хирург хирургом
зима: зимой зима зиму
помещение: помещении
анемия: анемии
эпилепсия: эпилепсии эпилепсия эпилепсией
заболевание: заболеваниями заболевание заболеваниях заболеваниям заболевании заболеваний заболеванию заболевания заболеванием
участок: участками участке участках участки участков участку участкам участок
ожог: ожогами ожогом ожогах ожогов ожоги
воспаление: воспалений воспалению воспалениями воспалением воспалениях воспаление воспаления
свежий: свежей свежие свежее свежим свежая свежего свежем свежий
загар: загара загаре загар загаром
татуировка: татуировки татуировкой
родинка: родинку родинки родинок родинка
светлый: светлые светлым
оттенок: оттенком оттенка оттенков оттенок
услышать: услышать услышите услышала
ошибочный: ошибочными ошибочным
чрезмерно: чрезмерно
жжение: жжение
осложнение: осложнений осложнения
аллергия: аллергия аллергию аллергиях аллергии аллергией
выписать: выписали выписать
препарат: препаратами препарат препаратом препаратах препаратов препаратам препараты препарате препарата
аспирин: аспирина аспирин
прийтись: пришлось придется
кровотечение: кровотечению кровотечения кровотечений кровотечение кровотечением
курить: курят курить курит
минимум: минимум минимума
курение: курение курения
возникновение: возникновению возникновения возникновением
загорать: загорать
пользоваться: пользуйтесь пользуемся пользовались пользуюсь пользуется пользуются пользоваться пользуетесь пользуясь
склонность: склонность
сеанс: сеанса сеанс сеансов
профилактика: профилактикой профилактике профилактика профилактики профилактику
обезводить: обезвоженная
прекратить: прекратить
сауна: сауны саун сауну
алкоголь: алкоголем алкоголя алкоголь
очищать: очищает очищать очищают
пыль: пыль пыли
минута: минуту минут минуты минута
трубка: трубку трубкой
холодный: холодную холодные холодном холодной холодная холодным
воздух: воздухе воздухом воздуха воздух
занимать: занимают занимать занимает занимала
размер: размерами размер размеру размера размером размере
обрабатывать: обрабатываемых обрабатываемая обрабатывают обрабатываемой обрабатывает обрабатывать
класть: класть кладут
лёд: лёд лед льдом льда льду
идти: идет идти идут идете иди
домой: домой
планировать: планировать планирую планирует планирующий планировали планируете планируют
болеть: болеют болеешь болеет болела болеть болят болит болел
гореть: горят гори гореть
краснеть: краснеет
покрываться: покрывается покрываются
проникать: проникает проникая проникают
понадобиться: понадобятся понадобиться понадобится
восстановление: восстановлении восстановления восстановление
занять: занять заняла занятым
мазать: мажут
пакет: пакеты пакет пакета пакетами
дневник: дневник дневники
необязательный: необязательно необязательны
сидеть: сидит сидеть сидите сидели сидят сидящий сидя сидим
спортзал: спортзалом спортзала
чувствительный: чувствительны чувствительный чувствительные чувствительными чувствительной
защитный: защитная защитный защитные защитным защитную
пасмурный: пасмурную пасмурный
погода: погоду погоде погода погодой погоды
некоторый: некотором некоторыми некоторое некоторую некоторым
восемь: восемь восьми
десять: десять десяти
акне: акне
выбрать: выбрали выбрала выберите выбрать выбранные выбрал
согласиться: согласиться согласилась соглашусь
опыт: опыте опыта опыты опыту опытом опыт
подобный: подобной подобное
образование: образовании образований образования образованию образование образованием
почитать: почитайте почитать
обложка: обложка
пчела: пчел пчелы
сезон: сезона сезон сезоне сезону
март: марте марта
слушать: слушать слушали слушают слушайте слушает
вещество: вещество веществами веществ веществам вещества веществе
эффективность: эффективности эффективностью эффективность
продавать: продают продавать
аптека: аптеках аптеке аптека
пустышка: пустышка пустышку пустышки
соцсеть: соцсети
послушать: послушать послушайте
сеть: сеть сети сетями сетях
звук: звук звуки звуков
яд: яды яда яд ядом
мёд: медом меда мед
альтернативный: альтернативными альтернативной альтернативным альтернативные
доказательство: доказательств доказательства доказательством
реакция: реакцией реакциях реакцию реакция реакции реакций
шок: шок шоке шока
тяжёлый: тяжелой тяжелом тяжелых тяжелый тяжело тяжелые тяжелым тяжелое тяжелыми тяжелее
заканчиваться: заканчивается заканчиваются
смерть: смерть смертью смерти смертей
народный: народной народная народных народные
целитель: целители
артрит: артрите артрит артритом
склероз: склероз склерозе склерозом
теория: теории теорий теориях теория теорию
строиться: строится
февраль: февраля
ванна: ванны ванне ванн ванна ванну
январь: января
пиявка: пиявки
вылечить: вылечить вылечит вылечат
бесплодие: бесплодием бесплодия бесплодии бесплодие бесплодию
проверка: проверках проверка проверки проверку проверок проверке
слух: слух слухи слуха
принять: примет примут принято приняли принять
мужской: мужскому мужском мужскую мужское мужских мужской мужская
видеться: видится видятся
повсюду: повсюду
стероид: стероиды стероидов
прилив: прилив
грызун: грызунов
удаление: удалению удаления удаление удалении
превратиться: превратится превратился
невероятный: невероятного
агрессия: агрессии агрессией агрессия агрессию
отрицательный: отрицательного отрицательные отрицательный отрицательную
взаимосвязь: взаимосвязь взаимосвязей взаимосвязи
механизм: механизмами механизмы механизма механизму механизм механизме
регулировать: регулируемой регулировать регулируют регулирует
множество: множество множеством множества множеству
биологический: биологических биологической биологическими
эндокринология: эндокринологии
когнитивный: когнитивные когнитивными когнитивных когнитивная когнитивной
выясниться: выяснилось
точный: точный точная точной точное точную
корреляция: корреляцию
учёный: учеными ученый ученых ученые ученым
мешать: мешая мешали мешать мешает мешают мешайте
переменный: переменные переменными
участник: участника участниками участник участники участников участникам
выделяться: выделяется
плацебо: плацебо
контролируемый: контролируемые
испытание: испытаниях испытание испытаний испытания
получать: получает получаемые получали получающих получала получаю получаемых получаемым получать получаемая получают получайте
золотой: золотых золотому золотого золотые золотой
стандарт: стандарт стандартов стандарты стандарта стандартам
показать: показанных показал показали показать покажет показано показало покажут показала
писать: писал пиши писали пишет пишешь писать пишут
преувеличивать: преувеличивает преувеличивают преувеличиваем
иметься: имеющуюся имеющиеся имеющихся имеющейся
краткосрочный: краткосрочный краткосрочной краткосрочные
следствие: следствие следствием
кора: кору коры кора коре
предположение: предположения предположение
косвенно: косвенно
указывать: указывающие указывает указывающий указывать указывали указывают
принятие: принятия принятие принятии принятием
отлично: отлично
поражение: поражения
импульсивный: импульсивному импульсивны
гипотеза: гипотеза гипотезу гипотезы гипотезе
зона: зона зоне зон зонам зону зоны
оборот: обороты оборот
понизить: пониженной понижен пониженного
увеличивать: увеличивает увеличивают увеличивать
требовать: требовать требуемой требуя требует требовала требуют
вкалывать: вкалывают
справедливый: справедливо справедливы
экономист: экономист
университет: университета университет
коллега: коллега коллегу коллег коллеги
торг: торг
проверить: проверит проверьте проверить проверенных проверенные
пара: парам пары паре пар пару парами пара парах
делить: делили делит делят делить
деньга: денег деньги
выдвигать: выдвигал выдвигая выдвигает
предложение: предложения предложениям
странно: странно
торговаться: торговались
идея: идеями идею идеи идея идее
настолько: настолько
укорениться: укоренилась
человеческий: человеческих человеческой
контроль: контроля контролем контроль контролю контроле
эмоция: эмоциям эмоций эмоциями эмоцию эмоция эмоции
необходимый: необходим необходимой необходимого необходимое необходимыми необходима необходимый необходимую необходимых необходимы
выяснить: выяснила выяснить выясним выяснили
опосредовать: опосредует
личность: личности личность
умереть: умрет умру умер умрем умершем умереть умрут
запомнить: запомним запомнить
интервью: интервью
забегаловка: забегаловки
ночь: ночью ночь ночи ночам
кухня: кухни кухню кухня кухне
фильм: фильме фильм фильма фильмы фильмов
рецепт: рецепта рецептов рецепт
любовь: любви любовью любовь
биомеханика: биомеханика
революция: революции революция
оставить: оставлю оставлено оставил оставьте оставить
фотография: фотографиями фотографии фотография фотографий фотографией
мастерская: мастерской
озорной: озорные
частушка: частушки
итальянский: итальянские итальянской итальянский
комедия: комедии
сочетание: сочетании сочетание сочетанием
покупать: покупать покупал покупаю покупая покупает покупала
банка: банок банку банки банка
мороженое: мороженого мороженое
забрать: забрала
античный: античное
олимпиада: олимпиада
сперма: сперма сперму спермы сперме спермой
драка: драки драку
паб: пабах
принцесса: принцесса принцессы
пришелец: пришельцев
паук: паук пауков
космос: космоса космосе
убить: убила убил убитая убить
выставка: выставки выставка выставке
смешной: смешным смешно смешные
трогательный: трогательные
великий: великого великая великой великих
тысяча: тысячам тысячи тысячу тысячей тысяч
литература: литературой литературу литература литературы литературе
бедный: бедных
квартал: кварталов
мировой: мировыми мировой мировые
геройство: геройство
хоспис: хосписа
маяк: маяком
смех: смех
стихия: стихий
мертвец: мертвецы
аукцион: аукцион
выигрывать: выигрывает
арт: арт арта
рынок: рынке рынок рынков
громкий: громкий
мультфильм: мультфильма мультфильм мультфильме
земля: земли земля
гончар: гончара
гигантский: гигантскую
берлин: берлином
рок: рок роке
ролл: ролл роллы
сообщить: сообщите сообщили сообщить сообщило
счастье: счастье
пирог: пирогах
конфета: конфетах конфет конфеты
птичка: птичка
группа: групп группами группы группой группу группам группа группе группах
дог: дога
выступление: выступление выступлением выступления
спальня: спальня
воздушный: воздушным воздушные воздушно
телефон: телефону телефон телефонам телефоны телефона телефоне
оба: обоих обоим обе
самолёт: самолете самолеты самолетах
расизм: расизм
нацизм: нацизм
танец: танцев танец танцы
панк: панк
сурок: сурка
дно: дне
лебёдушка: лебедушек
диктатура: диктатура
джентльмен: джентльменов
миф: миф мифами мифу мифа мифы мифов
комфорт: комфорта комфорт
принятый: принято
отличаться: отличаться отличается отличаются
суть: сути
страсть: страсть страсти
норадреналин: норадреналин
начальный: начальном
значительный: значительную значительных значительное значительный
приток: притока приток
ощущать: ощущаете ощущала ощущает ощущаю ощущать
навязчивый: навязчивых навязчивое навязчивую навязчивые навязчивой
фиксация: фиксацию
безразличие: безразличия
касаться: касаться касающуюся касаются касающихся касается касающиеся
счастие: счастья счастью счастье
вещь: вещей вещах вещам вещь вещи
приходить: приходят приходите приходит приходить
привязанность: привязанности привязанность
управлять: управлять управляет
окситоцин: окситоцин окситоцина
ценить: ценить ценю ценят
длительный: длительные длительном длительный длительное длительного длительных
крепкий: крепкие крепкими
буря: буря бури
обыденный: обыденной
привычный: привычного привычной привычному привычная
знакомый: знакомого знакомы знакомо знаком
показаться: показаться
соскучиться: соскучиться
настать: настать
кризис: кризисе кризиса
конфликт: конфликты конфликт конфликтов
комфортный: комфортных комфортнее комфортный комфортную комфортной комфортна комфортно комфортным комфортны комфортного
нежный: нежных нежнее нежной нежная нежное нежным нежные нежный
заканчивать: заканчивать
отказываться: отказываются отказывается отказываться
влюбиться: влюбился влюбилась
сожаление: сожалению
назвать: назвали назвать названа
цифра: цифру цифрой цифра цифры
частота: частоту частота частоты
находиться: находящиеся находится находятся находящихся
одинокий: одиноки
любовный: любовные
погасить: погасить
внезапно: внезапно
стратегия: стратегии стратегия
убеждение: убеждения убеждение убеждениями убеждений
перспектива: перспективе
утвердить: утвердить
допустимый: допустимых допустимы допустимой допустимые допустимо
форма: форму формы форм форме формой форма формах
беспокойство: беспокойствах беспокойства беспокойство беспокойстве
сильно: сильно
разнообразить: разнообразить
парный: парная
психотерапия: психотерапия психотерапию психотерапией психотерапии
справиться: справятся справимся справится справиться справились справилась
задать: задаст задать задали
завершение: завершения
одновременно: одновременно
яркий: ярких яркой яркого яркий яркими ярко яркие
осознанный: осознанным
рассмотреть: рассмотрели рассмотрим рассмотреть
неудача: неудачи неудача неудачам
возбуждение: возбуждения возбуждению возбуждение возбуждением
мысль: мыслях мыслями мысль мысли мыслей
отразиться: отразится
вероятность: вероятностью вероятность
совершенно: совершенно
применить: применить
приносить: приносят приносит приносили приносить
значимый: значимый значимыми значимые значимым
обижаться: обижаемся
дарить: дарящие дарить дарит
обида: обиды обид обиду
ожидание: ожидания ожиданий ожидании ожидание
злость: злость злости
горечь: горечь
битва: битва битвы
сочувствие: сочувствие
би: би
шаг: шаг шагом шагами шагам шаги шагов
недопонимание: недопониманий недопонимание
открыто: открыто
обмениваться: обмениваться
придумывать: придумывать придумывали придумывают
повод: поводы поводу поводом повод поводов
значить: значат
копить: копит копить
прощение: прощение
избавление: избавлению избавление
выраженность: выраженность
представлять: представлять представляю представляла представляли представляем представляют представляет
измена: измена
упростить: упростить упрощена
договорённость: договоренностей
недопустимый: недопустимо
делиться: делятся делитесь делиться делимся делится
любой: любым любому любые
нарушать: нарушающих нарушает нарушать нарушают
личный: личными личный личном личные личную личного личных личной личное
причинять: причиняют причиняет причинять
беспокоить: беспокоит беспокоят беспокоить
сфера: сферой сфере сферу
заработок: заработок
прямо: прямо
диалог: диалог диалоге
доход: дохода
бороться: бороться борется борются боролись
распознать: распознать
радоваться: радуется радоваться радуемся радуются
бесплатно: бесплатно
добавлять: добавляют добавляли добавлять
виджет: виджеты
мероприятие: мероприятиях мероприятии мероприятия мероприятие мероприятием
поблизости: поблизости
дорога: дороги дороге дорогу дорог дорогам
русский: русской русском русский
кофе: кофе
единый: единого единой единым
задача: задаче задача задачей задачам задачу задачи
спокойный: спокойное спокойные спокойнее спокойными спокойным спокойный
подробно: подробно
общество: общества обществах обществе общество
утро: утрам утром утра
успокоиться: успокоилась успокоиться
оказываться: оказывается
пьянеть: пьянеет
свойство: свойствам свойствами свойствах свойств свойства
особенность: особенности особенность особенностями особенностей особенностях
изготовление: изготовления
микроорганизм: микроорганизмами
химический: химическая химическому химические химическими химической химических
контекст: контексте контекст контекста
катехин: катехин
цвет: цвета цвет цветами цветов цвете цветом цвету
чаепитие: чаепития
надеть: надели наденьте надеть надев наденем надела
голова: голова головой головы голове голову
электрод: электродами
попросить: попросили попросить попросит попросил
выполнять: выполнял выполняли выполнять выполняет выполняют
электроэнцефалограмма: электроэнцефалограмме
тета: тета
отметить: отметить отметили отметил отметим отметила
мозговой: мозговые
эзотерика: эзотерики эзотерика
способный: способна способно способны способен
кровоток: кровоток
управление: управления управление
нажимать: нажимаем нажимает нажимать
рычаг: рычаги
выборочно: выборочно
выполнение: выполнения выполнение выполнении
шум: шумы шум
кофеин: кофеин кофеина кофеином
рабочий: рабочий рабочую рабочим рабочей рабочем рабочего рабочих
память: памятью память памяти
скорость: скорости скорость скоростью
неизвестный: неизвестна неизвестно
замашка: замашки
отдельный: отдельные отдельного отдельных отдельный
вывод: вывод выводами выводы выводу выводов выводам
потребление: потребление потребления
выпивать: выпивал
кружка: кружку кружки
обработка: обработке обработки обработка обработку
концентрация: концентрация концентрации концентрацию концентрацией
контролироваться: контролировались
скептически: скептически
шах: шах
мат: мат
объяснение: объяснений объяснение
способствовать: способствующим способствуют способствует способствовать
чашка: чашка чашки чашку
звучать: звучит
отнестись: отнестись отнесся отнесется
приятный: приятно приятное приятны приятный приятным приятную приятнее приятного приятные приятных приятной
полезный: полезную полезно полезны полезных полезным полезные полезными полезен полезное полезнее полезна полезный полезной
нежели: нежели
чемодан: чемоданы
лететь: лететь летишь
горный: горные горной горном горный
церемония: церемониях церемониями
трудность: трудностях трудности трудностей
вредный: вреден вредное вредны вредного вредных вредные вредна вреднее вредному вредным вредно вредными
японский: японской японских японский
пять: пятью пять пяти
протеиновый: протеиновое протеиновые протеиновый протеиновом
включить: включены включено включите включенных включить включена включим
структура: структуры структура структур структуру
стержень: стержень стержня
видимый: видимый видимых видимая видимого
основание: основания основании основаниям основание основанию
расширяться: расширяется расширяются
круглый: круглые круглой круглый круглая
луковица: луковице луковица луковицы
дермальный: дермальный
специальный: специальные специальной специальном специальную специальный специальным специальных специальное
затвердевать: затвердевают
продолжать: продолжать продолжал продолжают продолжали продолжает
снизу: снизу
лицо: лицом лицу лица лиц лицам лицами лицах лице лицо
ресница: ресниц ресницы
бровь: бровей брови бровями
уменьшаться: уменьшается
седой: седыми
толщина: толщина толщины толщину
генетический: генетическими генетических генетическая генетические генетическое
физиологический: физиологическим физиологическая физиологические физиологических физиологическими физиологической физиологического физиологический
удаляться: удаляется удаляются
выступать: выступает выступают
тупой: тупыми тупые
режущий: режущий
край: края краем край
лезвие: лезвия
оставлять: оставляя оставлять оставляет оставляла оставляю оставляют
прямой: прямой прямая прямую прямых прямого
отличие: отличий отличия отличие
густой: густые густых густой
характеристика: характеристику характеристиками характеристиках характеристика характеристик характеристики
баланс: баланса балансом баланс
иллюзия: иллюзия
визуальный: визуальным визуальное
восприятие: восприятие восприятия восприятием
раздражение: раздражений раздражения раздражением раздражение раздражению
семь: семь
удалять: удаляет удаляют удалять
выпускать: выпускаем выпускающая выпускающий выпускают
обзор: обзоры обзора обзоре обзору обзор
игрушка: игрушки игрушку игрушек
полигамия: полигамии
моногамия: моногамии
восторг: восторге
ажиотаж: ажиотажа
психиатр: психиатром психиатр психиатры психиатру психиатра
конституция: конституции конституцию конституция конституцией
универсальный: универсальна универсальный универсального универсальных
средний: средние среднюю средней средняя
слабый: слабый слабее слабой слабое слабых слабую
утверждение: утверждения утверждение утверждению
совокупность: совокупность
либидо: либидо
прежний: прежний прежней
обстоятельство: обстоятельства обстоятельств
порядок: порядком порядке порядок порядку порядка
опрос: опрос опросу опросам опроса опросы
американец: американцев
достаточно: достаточно
несчастный: несчастных несчастного несчастнее
оценка: оценке оценками оценкам оценки оценка
шкала: шкале шкалу шкалы
вспомнить: вспомнить
параметр: параметра параметром параметру параметр параметры параметрам
максимальный: максимальный максимальную максимальной максимального максимальное
семяизвержение: семяизвержений семяизвержения семяизвержением
отбить: отбить
несколько: нескольких нескольким несколькими
пример: примерах пример примеру примеры
целовать: целовать целуют
модель: модели модель моделей
автоматически: автоматически
глаз: глаза глазами глазом глаз глазах глазу
целоваться: целоваться
род: роды родах рода роду родов родам
рожать: рожать рожаем рожают
фото: фото
бельё: белье бельем белья
издеваться: издеваться
шлюха: шлюхой
спина: спиной спине спина спины спину
обратный: обратную обратном обратная обратное обратной
круто: круто
девственница: девственница девственниц девственницы
переспать: переспать
подруга: подруге подругам подругу подруг подруга подругой подруги
восторженный: восторженные
сверстница: сверстниц
захотеть: захотел захотят захотите захочет
сложность: сложность сложности
построение: построения построением
выражаться: выражаться выражается
привлекательный: привлекательные привлекательный привлекательным привлекательных привлекательными привлекательного привлекательной
извращение: извращение
тратить: тратить тратят
возня: возню
кровать: кровати кровать
прогулка: прогулки прогулку
парк: парк парке
тревожить: тревожит
фригидность: фригидность фригидности
спасать: спасает спасают
заставить: заставить заставил
выброс: выброс выбросом выбросы
довольный: довольный довольны довольна довольным
непроизвольно: непроизвольно
эрекция: эрекцию эрекции эрекция
выполнить: выполненная выполнив выполнить
условный: условное условный условные
долг: долгу долг
цена: ценой цену цены цена
семейный: семейной семейную семейному семейный семейная
спокойно: спокойно
поток: поток
называться: называются называется
техника: технику технике техника техники техникой
принцип: принципу принципах принципам принципы принципе принципами принцип принципа принципов
жертва: жертвой жертвами жертвы
строение: строении строение строения
сохранить: сохранить сохранила сохранив
неполноценный: неполноценная неполноценными
помпа: помпа помпу помпы
гид: гид
эрогенный: эрогенным эрогенные эрогенных
актуальный: актуальное актуальна актуальной актуальным актуален актуальные актуальном актуальны
скорый: скорой скорая
мина: мин
тестирование: тестирование
таблетка: таблетки таблеток таблетка таблетками таблетках таблетку
запор: запоров запор запорами запоры
анальный: анальным анальном анальную анальная
трещина: трещинам трещин трещинами трещина трещины трещину
гипергидроз: гипергидроз
пневмония: пневмония
холера: холера
волосы: волосы
паста: паста пастой пасты
польза: польза пользу пользе пользы
диета: диете диета диету диеты диет
лепесток: лепестков
тревожный: тревожными тревожный тревожного тревожную тревожным тревожная тревожное тревожны тревожные тревожном
эффективный: эффективные эффективен эффективны эффективной эффективнее эффективная эффективным эффективно эффективных эффективный эффективными эффективна
древний: древние древнем древней древних
зомби: зомби
вирус: вирус вируса вирусов вирусы вирусами
вакцина: вакцине вакцины вакцина вакциной
томат: томаты томатов
перепад: перепады перепада
разграничивать: разграничивают
смартфон: смартфона смартфонах смартфоны
плохой: плохой плохие плохо плохое плохая плохим плохих худшего худшие плохую плохом плохого
изнутри: изнутри
буккальный: буккальный
массаж: массаж массажа
растение: растение растения растениях растений
морковь: моркови морковь
свёкла: свеклу свекла
плесень: плесень
подробный: подробнее подробные поподробнее подробную подробный
тренер: тренером тренеру тренера тренер
машина: машины машине
сковородка: сковородки
ладонь: ладонях ладони ладонь ладоней
являться: являюсь являющееся являющемуся являются является
жаркий: жаркой жарком
температура: температурой температуре температуры температур температура температуру
предотвращать: предотвращать предотвращает предотвращают
покой: покоя покое покой
патологический: патологическое патологический патологической патологическому патологического
классификация: классификации классификация
спровоцировать: спровоцировать спровоцирует
бактерия: бактериями бактерий бактерии
смешиваться: смешиваются смешиваясь
осмотр: осмотрах осмотр осмотре
моча: мочой моче мочи мочу моча
йодный: йодный йодная
раствор: раствора раствор
йод: йода
крахмал: крахмала крахмалом
комбинация: комбинация комбинации
окрашивать: окрашивает
синий: синюю синие синего синяя синей
избыток: избытке избыток избытка
впитывать: впитывает
взвешивать: взвешивают
проток: протоки
хлорид: хлоридом хлорид хлорида
алюминий: алюминий алюминия
линия: линии линиям
предотвратить: предотвратить
ионофорез: ионофорез ионофорезу
помещать: помещает помещают
устройство: устройств устройством устройства устройстве устройствами устройству устройство устройствах
электрический: электрических электрические электрический
блокировать: блокирующий блокируют блокировать блокирует блокирующих
токсин: токсины токсинами токсинов токсин
дорогой: дорогого дорогие дорого дорогой дорогим
повторный: повторные повторного повторную повторном
торакальный: торакальная
инвазивный: инвазивная
перерезать: перерезает
операция: операций операцию операция операции
сопрячь: сопряжена
рассматривать: рассматривают рассматривали рассматриваем рассматривала рассматривать рассматриваете
пробовать: пробовать пробовали пробовала пробуйте
хирургический: хирургическое хирургическую
вмешательство: вмешательство вмешательства вмешательств
долгосрочный: долгосрочный долгосрочной долгосрочные долгосрочную долгосрочному долгосрочная
стойкий: стойкая стойком стойкого стойкий стойкими стойкие стойких
визит: визитов визиты визит
любимый: любимая любимую любимых любимом любимой любимого любимые любимыми
спать: спал спите спать
перчатка: перчатки перчаток
нравиться: нравилось нравится нравятся нравиться
собственный: собственной собственные собственная собственного собственный собственную
бактериальный: бактериальными бактериальной бактериального
разбавлять: разбавляет разбавлять
щелочной: щелочная щелочной щелочную щелочного
отправлять: отправляйте отправляют отправлять отправляемые отправляли
неприятно: неприятно
носить: носила носят носили носит ношу носить
обувь: обуви обувь
оригинальный: оригинальный оригинальные оригинального
заменять: заменяет заменяют заменяю заменять
мошонка: мошонку мошонка
вульва: вульва
имя: именами имени именем имя
неловкий: неловкий неловком неловко
оградить: оградить
статистика: статистики статистике
повсеместно: повсеместно
громко: громко
чесаться: чешется чесаться чешутся
незнакомый: незнакомых незнакомой незнакомыми
обсуждение: обсуждений обсуждения обсуждение обсуждении
пися: пися
чреватый: чревато
верить: верили веришь верят верить верит
заставлять: заставляет заставляло заставлять заставляют заставляли
случиться: случился случившуюся случилось случилась случиться случившемся случится
инструмент: инструментов инструмент инструментом инструмента инструменты
задел: задел
приставать: приставать пристает
домогаться: домогаться
обо: обо
собака: собаки собакой собаку собаками собака собак
коричневый: коричневая коричневые коричневый
начаться: начнутся начнется начались началось начаться
уверенно: уверенно
анус: ануса анус
зеркало: зеркале зеркало зеркала зеркалом
шесть: шестью шесть шести
купание: купание купании
подгузник: подгузник подгузников подгузникам подгузнике подгузники
локоть: локоть
сохраниться: сохранится сохранилось
ровный: ровной ровное ровным ровный
различие: различие различия различий различиях
помешать: помешал помешать помешает
радостно: радостно
хвалить: хвалят
легче: легче
мыться: мыться
проговаривать: проговаривать
очерёдность: очередность
мыть: мыли мыть моющие
направление: направления направлениях направлению направление направлении направлений
лобок: лобка
одиночка: одиночку одиночки
обсудить: обсудили обсудите обсудить обсудим
получиться: получилось получится
привыкать: привыкает привыкают
эпизод: эпизода эпизодов эпизод
кремль: кремль
звезда: звезды звездой звезда звезд звездами
колония: колонии
известный: известной известные известная известных известны известно известное известным известный
жестокий: жестокими
заключение: заключению заключением
приговорить: приговорен
тезис: тезисами
республика: республике
упустить: упустила
шанс: шансы шанс шансов
политический: политического политическая политической
отравление: отравления отравлениях отравлением отравление отравлении
убивать: убивает убивают
украина: украине
слава: слава
фраза: фраз фразы фраза фразами
свободный: свободна свободным свободными свободных свободное свободной свободный свободного
встать: встал встать встала
лозунг: лозунгами
российский: российских российский российские российском российская российского российской российскую
власть: власти власть
обвинять: обвиняет
враг: врагов
восемнадцатый: восемнадцатый
церковь: церковь церкви
колокол: колокол
храм: храмы
легенда: легенды
позволить: позволит позволил позволят позволило позволить
подпись: подписью подписи
перемена: перемены переменам переменами
навигация: навигацией навигации навигация навигацию
медуза: медузы медуза медузу
кодекс: кодекс
радио: радио
платформа: платформе платформу платформ платформы платформа
создатель: создателей создатели
спам: спама
блокировка: блокировка блокировки
ошибка: ошибка ошибку ошибки ошибок ошибках
нажать: нажать нажмите
шеф: шеф
журналист: журналист журналисты журналистами
открытие: открытие открытиях открытием открытий
разработка: разработкой разработках разработка разработки
окончить: окончила
петербургский: петербургский
специальность: специальность специальности
редактирование: редактирование
прокладка: прокладках прокладок прокладки
чаша: чаши чашу
отказ: отказом отказа отказе отказ
популярный: популярной популярны популярно популярному популярным популярную популярными популярные популярен популярных
привлечь: привлек привлечь привлекло
общественный: общественный общественного общественных общественном общественное
высказывать: высказывает высказывали
протест: протест
марафон: марафон
пробежать: пробежала
свободно: свободно
бедность: бедности
расход: расходы
покупка: покупке покупки покупкой покупок покупку покупках
противник: противники
экстравагантный: экстравагантный экстравагантной
чужой: чужой чужих чужом
гинеколог: гинекологу гинекологом гинеколога гинекологи гинеколог
регулярность: регулярность регулярностью
действенный: действенный
стыдный: стыдной
мера: мер меру мере меры
предосторожность: предосторожности
соблюдать: соблюдают соблюдать
опасаться: опасаться
холодно: холодно
принести: принеси принести принесет принесла
табу: табу
достоверный: достоверную достоверными достоверных
представление: представлениями представления представление
патология: патологии патологий патологией патология
обильный: обильных обильные обильном обильная обильную
полип: полипов
приход: приходу приходом
больной: больное больным больными больны больные больных больно больному больна
умирать: умираете умираю умирают умирает
близкий: близкому близких близкие близким ближайших близкого ближайшем близкая близка
разговаривать: разговаривайте разговаривали разговаривают разговаривать разговаривает
открытый: открытым открытое открытые открытый открытой открытых открытом открытыми
индикатор: индикаторы индикатор
знание: знаний знание знаниями знания
моральный: моральному моральные моральном моральное морального
давление: давлением давление давления давлении
страшный: страшного страшные страшных страшнее страшно
ночной: ночных ночную ночная
трагедия: трагедию трагедия
апокалипсис: апокалипсиса апокалипсис
загадочный: загадочного
основать: основанный основан основаны
догадка: догадках
магический: магических
писатель: писатель
обладать: обладают обладает обладать
способность: способностями способностей способности способность
присутствие: присутствия присутствии присутствием
тускнеть: тускнеют
переставать: перестает перестают переставать
плодоносить: плодоносить
плод: плода плоду плоды
дерево: деревом деревьев дерева деревьями дерево
оружие: оружие
улей: ульи
гибнуть: гибнут
впадать: впадали впадают
бешенство: бешенстве бешенства бешенство
религия: религия религии религией
совершать: совершающих совершать совершаемых совершаемые
религиозный: религиозным религиозный религиозному религиозную религиозными религиозной религиозная религиозных религиозные религиозен
обряд: обряды обрядов
алтарь: алтарю
молитва: молитва молитвы
век: веков веке века век
грех: грех грехи
малый: меньшем малейшего малом меньшему меньшей малая меньшим меньших меньший малых
снисхождение: снисхождения
традиция: традиции традициях
дискуссия: дискуссии
ограничение: ограничений ограничения ограничение
вред: вреда вред вреде
недавний: недавние недавних недавнем недавнего
постыдный: постыдным постыдного постыдной
красный: красный красную красное красные красных красного красной
иносказание: иносказания
замалчивать: замалчивали
скрытность: скрытность
сумка: сумку сумке сумка
поднять: поднятой поднята поднять поднимут
недостаточный: недостаточной недостаточно недостаточное недостаточным
правдивый: правдивую правдива
гинекология: гинекология гинекологии
июнь: июня
игла: иглами
нанести: нанести нанесла нанесите нанесенного нанесли
инъекция: инъекции инъекциями инъекцию инъекция инъекций
май: мая май
газовый: газовых газовыми газовые
красивый: красивые красивой красивыми красивое красивых красивого красивее красивый
рысь: рысь
достижение: достижения достижением достижениях достижениями
вибратор: вибратор вибраторов вибратора
предмет: предметов предметах предмет предметами предметам предметы предметом
взаимный: взаимной
совместно: совместно
получение: получение получением получению получения
короткий: короткими короткой коротким короткий короткого короткие короткая короткое
промежуток: промежуток
минимальный: минимальная минимальными минимальных минимален минимальное минимальный минимальной
учёба: учебе
тайна: тайну тайны
фертильность: фертильности фертильность
оптимальный: оптимальное оптимальный
эякуляция: эякуляцией эякуляцию эякуляции эякуляций
подвижность: подвижность
сперматозоид: сперматозоида сперматозоидами сперматозоидов сперматозоид сперматозоиды
самоудовлетворение: самоудовлетворение
участие: участие участия участием
спортсмен: спортсменов спортсмен спортсмена спортсменам
явление: явлением явление явлений
укрепление: укреплению укрепление укрепления
широкий: шире широкого широким
спектр: спектром спектр спектра
импотенция: импотенции
недуг: недугов
положительно: положительно
укрепить: укрепить
простуда: простуду простуда простуды
повышать: повышает повышающие повышают повышать
рассчитывать: рассчитывать
рак: раке рак раку рака раком
простата: простаты
заболеть: заболеет заболит заболела заболеть
ассоциация: ассоциацией ассоциация ассоциации
надёжный: надежно надежную надежнее надежный надежных надежным
бессонница: бессоннице бессонница
пролактин: пролактином пролактина пролактин
совместный: совместных совместном совместные совместное
снотворный: снотворного
перерыв: перерыва перерыв перерывы
оболочка: оболочек оболочку оболочкой оболочки
кишка: кишки кишку кишка
заработать: заработать
перелом: переломы переломе перелом переломах
опасность: опасность опасности опасностей
публикация: публикация публикацией публикаций публикациях публикации
спросить: спросить спросил спросили спросите
чек: чек
вера: веру вера
всемирный: всемирная всемирной
организация: организаций организации организацией организация
здравоохранение: здравоохранения
преимущество: преимущества преимуществ преимущество преимуществах преимуществами преимуществом
искусственный: искусственному искусственном искусственным искусственного искусственных
обратить: обратить
готовность: готовность готовности
поддержка: поддержки поддержке поддержкой поддержка поддержку
рот: ртом рту рот рта
выталкивать: выталкивает
язык: язык языка языке языком
обратно: обратно
тянуть: тянуть тянет
кусочек: кусочка кусочек кусочки
тянуться: тянется
демонстрировать: демонстрируют демонстрирует
поступать: поступающим поступал поступают поступает поступать
учиться: учимся учились учатся учиться
жевать: жевать
аппарат: аппараты аппаратом аппарата аппарат
последующий: последующее последующего последующим последующей последующий
речь: речь речи речью
основываться: основывались основываясь основывается
обычай: обычаях
консистенция: консистенции консистенция консистенцию консистенцией
крупа: крупы круп
мясо: мяса мясе мясо
белок: белков белка белки белок белками
фрукт: фрукты фруктах фруктов
овощ: овощи овощах овощей
покупной: покупная покупное покупных
овощной: овощное
мясной: мясное
йогурт: йогурты йогурт йогурта
приготовить: приготовленный приготовить
смешивать: смешивать
глотать: глотать
каша: каша каши кашу
жидкий: жидкие жидкое жидким жидкий жидкими жидкой жидкого
однородный: однородное
варить: варить варят
тушить: тушить
твёрдый: твердым твердое твердые
яблоко: яблоки яблоко
легко: легко
вилка: вилкой
птица: птицам птицы птице
рыба: рыбы рыбу рыба
приготовление: приготовлением приготовления
практически: практически
мягкий: мягким мягких мягкие мягче мягкий мягкую мягкая
ягода: ягоды ягод
семя: семян семенами семена
косточка: косточку косточек
цилиндрический: цилиндрические
резать: резать
кружок: кружками
помидор: помидоров помидоры
горло: горле горла горло
сокращать: сокращать сокращают
введение: введения введении введению
кормление: кормление
грудь: грудью грудь груди
желательный: желательно
ложка: ложке ложки ложка ложек ложку
познакомиться: познакомилась познакомиться познакомился познакомились
обязательно: обязательно
объём: объема объеме объем
добавить: добавил добавленных добавить добавят добавит добавив добавленный добавила добавьте
перекус: перекуса перекусы
ввести: введен ввел ввести ввела
выпечка: выпечка выпечкой выпечку
спор: спорах спор споры споров
тракт: трактом тракт тракта
сырой: сырое сырой сырого сырую
яйцо: яиц яйцо яйца яйцах
желток: желток
сыр: сыр
лесной: лесной лесные
гриб: грибов гриб грибы
ртуть: ртути
марлин: марлин
подавиться: подавиться подавился
специально: специально
натирать: натирать
половинка: половинки
орех: орехов ореха орехи
зерно: зерен зерна
жвачка: жвачку жвачке жвачки
леденец: леденцами леденцы
сушка: сушки
сухарь: сухари
ограничивать: ограничивать ограничивает
белка: белке
минерал: минерала минерале минералов минералами минералы минералах
насыщенный: насыщенных насыщенные насыщенной
витаминный: витаминных витаминными
категория: категорию категории категорий категория
сахар: сахар сахаром сахару сахара сахаре
сок: сока соки соках соке сок
клетчатка: клетчатки клетчатка
целый: целую целый целого целых целыми целые
солёный: соленые соленая соленого соленой
натрий: натрий
соль: солью соль соли
крекер: крекеры
переработка: переработки
колбасный: колбасные
изделие: изделия изделиях
сухой: сухая сухой сухих сухим сухого сухую сухими сухие сухом
завтрак: завтрака завтраки завтрак
икра: икр икры
закончиться: закончится
скутер: скутеров скутере
мотоцикл: мотоциклов мотоцикле
проложить: проложить
поездка: поездки поездку поездкой
мобильный: мобильных мобильный мобильного
исключать: исключать исключают
транспорт: транспорте транспорта
узкий: узкой узким узких
левый: левом левая левой
путь: путем путь путями пути путей
поворот: поворот повороты поворотах
экран: экране экран экраны экрана
остановка: остановки остановок остановку
ярлык: ярлык
адрес: адресов адресе адреса адрес адресом
вдоль: вдоль
ассистент: ассистент
отправление: отправления
автобус: автобусов
поезд: поездов
парковка: парковки
устранение: устранении устранения устранение
неполадка: неполадок
уведомление: уведомление уведомления
оплата: оплата оплату оплаты оплате
проезд: проезда
шапка: шапку шапкой шапки
реалия: реалиях
дружить: дружим дружит
искать: ищет ищут искала искать ищем ищете
роды: роды
сопутствовать: сопутствующих сопутствующие
беби: беби
блюз: блюз
специалист: специалисту специалистов специалистам специалистом специалист специалистами специалиста специалисты
молодой: молодых молодого молодое молодой молодые молодым
преодоление: преодоления
отец: отца отце отец отцов отцами
служить: служит служить
роддом: роддомами роддом роддома
травля: травлей
апрель: апреля
потратить: потратили
миллиард: миллиардов миллиарды
доллар: долларов
декоративный: декоративных декоративную
производитель: производитель производителем производители производителей производителя
создать: созданы созданные создало созданных создали создал создан созданной созданная создать
толкать: толкать
заботиться: заботиться заботятся заботясь заботится
ненавязчиво: ненавязчиво
приобретение: приобретение приобретения
расстраиваться: расстраивается
самооценка: самооценку самооценка самооценкой самооценки
акцентировать: акцентируют
губа: губами губы губ губах
решительный: решительный решительны
благополучие: благополучие благополучии благополучия
помада: помады
экономический: экономического экономическую
спад: спада
стремление: стремлении стремление
выглядеть: выглядит выглядеть выгляжу выглядят выглядели выглядела
создание: созданию создания создании
ассоциировать: ассоциирована ассоциируют
статус: статусом статусе статусы
зарплата: зарплатой
казаться: кажутся
завидовать: завидуют
легкомысленный: легкомысленными
ухаживать: ухаживали ухаживают ухаживать ухаживающие ухаживает
дважды: дважды
учебный: учебные учебной учебного
поддержание: поддержанием поддержание поддержания поддержанию
программа: программ программа программе программы
студентка: студенткам студентки
прочитать: прочитали прочитал прочитала прочитать
раскрасить: раскрасили
рисунок: рисунок
прослушать: прослушали
классический: классические классический классическим классическую классическая
сосредоточенность: сосредоточенностью
забота: забота заботе забот
страдать: страдали страдают страдающими страдающих страдаем страдает страдать
системный: системной
счёт: счет счетов
парад: параде
сторонник: сторонники
круг: круга кругом кругах кругу круги кругов круг
крупный: крупные крупных крупнейших
оценить: оценить оценив
гвоздь: гвоздях
избавить: избавит
листовой: листовой листового
мусор: мусор
угодно: угодно
состав: составу составом состав составе составов состава
требование: требований требование требованиям требования
вкусный: вкусные вкусным вкуснее
вредить: вредит вредим вредят вредить
экология: экологии
термостойкий: термостойкого
пластик: пластика пластиков
пластмасса: пластмассы пластмасса
инертный: инертный инертны
выделять: выделяет выделял выделять выделяют
микроскопический: микроскопические микроскопического
пластиковый: пластиковой пластикового пластиковые пластиковых пластиковую пластиковый
частица: частицами частицы
последствие: последствиях последствия последствиям последствий
спонтанный: спонтанные спонтанное
съесть: съев съели съел съеденного съесть съедены
блюдо: блюд блюдо блюда
закон: законом закон закона законе закону
тяга: тяги тягу тяга
регион: регионов региона регионе регионах
достать: достала достать
несъедобный: несъедобного
нехватка: нехватку нехватки нехватке
железо: железа
вспышка: вспышки
микроэлемент: микроэлементы микроэлементами микроэлементов
избирательный: избирательного избирательный
голод: голод голода
лихорадка: лихорадке
рвота: рвота рвоте
терять: терять теряют теряет
соление: соленья
фастфуд: фастфуд
творог: творога творог
реальность: реальность реальности реальностью
соотноситься: соотносится
затруднять: затрудняют
шоколадка: шоколадки шоколадку
винить: винят
амин: амины
жирный: жирная жирное жирным жирные жирных жирной жирнее жирного жирными
кислота: кислота кислоту кислот кислоты кислотой
нестерпимый: нестерпимо нестерпимое
выжить: выжить
неудачный: неудачной неудачных
охота: охоты охотой
неурожай: неурожая
гнев: гневе гнева гневу гнев
печаль: печаль
привычка: привычек привычками привычки привычка
ритуал: ритуал ритуалы
практиковать: практиковать
сенсорный: сенсорные сенсорный сенсорная сенсорное
медитация: медитацию медитации медитация
общаться: общается общаемся общаются общаться
умный: умные умный умным умная
функционировать: функционирующая функционируют функционировать
ориентироваться: ориентируемся ориентироваться ориентируйтесь
пристрастие: пристрастия
некорректный: некорректно
подача: подачу подачей
чрезвычайно: чрезвычайно
кафе: кафе
браузер: браузеру браузером браузера браузерах браузер браузере
страница: страницы страниц страницу
компьютер: компьютерах компьютерам компьютера компьютер компьютером компьютеру компьютеров компьютере
запустить: запустите запустили запустят запущенных запустить запустила
настройка: настройки настройку настройка настроек
октябрь: октября
союзник: союзник союзнику
проживать: проживают проживать проживающих
предприниматель: предпринимателем
популяризатор: популяризатор популяризатором
гранулярность: гранулярность
интеллект: интеллектом интеллекта интеллект
расширять: расширять расширяют
позволять: позволяющая позволяешь позволяла позволяет позволяло позволять позволяют
выражать: выражаем выражать
грамотность: грамотность
сентябрь: сентября сентябрь
откровенный: откровенных откровенные откровенными откровенный
август: августа
июль: июля
придавать: придавать придает придают
уверенность: уверенности уверенностью
дерматолог: дерматологом дерматологи дерматолог дерматолога дерматологов
красиво: красиво
совмещать: совмещает
пластика: пластику
настаивать: настаивать настаивает настаивала настаивают настаивайте
сомнительный: сомнительных сомнительно сомнительные сомнительны
эстетический: эстетическая эстетическое эстетический эстетической
устранять: устраняет
рецептор: рецепторы
нейрон: нейронов нейроны
зуд: зуде зуд зуду зуда
зудеть: зудящее
ухо: уши ушей ухо ушах уха
пятка: пяткой пятки пятку
безо: безо
сообщать: сообщает сообщать
паразит: паразит паразитами
клоп: клопа
явный: явного
предупредить: предупредила предупредить
кожный: кожными кожное кожных кожного кожная кожные
тепло: тепло тепле тепла
окончание: окончаний окончания
механический: механическая механические
термический: термические
посредник: посредники
высвобождаться: высвобождаются высвобождаться
специализированный: специализированные
поверхностный: поверхностной поверхностных
волокно: волокна волокон
нечасто: нечасто
клик: кликов клик
стикер: стикер
аптечка: аптечку аптечка
капля: каплях капли
нос: носу носа нос
насморк: насморк
уходить: уходит уходят
здорово: здорово
какать: какать какает
микрофлора: микрофлоры микрофлору
предприятие: предприятиях
воздействие: воздействий воздействие воздействию воздействия воздействием воздействии
производство: производстве производству производство производств производства
контактировать: контактируют
патогенный: патогенными
пестицид: пестицидами
ионизировать: ионизирующего ионизирующим
излучение: излучения излучение излучением
подтверждение: подтверждение подтверждения подтверждений
нейтрализовать: нейтрализует нейтрализуют
калий: калия
цинк: цинком цинк цинка
завод: заводах
голодать: голодающим
обязанный: обязаны обязан
удаться: удалось удастся
пищевод: пищевода
диарея: диареей диарея
цельный: цельных цельные цельное
ненасыщенный: ненасыщенных
артерия: артерий
появление: появлении появления появление появлением
эмаль: эмали эмаль эмалью
стираться: стирается
эрозия: эрозия эрозии
стоматолог: стоматолог стоматологу стоматологом стоматологи
чистить: чистить чистит
зубной: зубные зубной зубного зубную зубных зубная
фтор: фтор фтора фтором
кислый: кислых кислую кислые кислая
соломинка: соломинку
есть: едите ели
фонд: фондах фонд фонда фонды
полость: полостью полости полость
бикини: бикини
нежелательный: нежелательной нежелательно
носок: носки носком носках
паутина: паутины
пластический: пластических пластическая пластическую пластические пластической пластическим
хирургия: хирургия хирургии
плоский: плоского плоский
пышный: пышной
навязывать: навязывает
миллион: миллионов миллионы миллиона
продвигать: продвигают продвигать
писательница: писательница писательницей
принуждение: принуждения
создаваться: создаются
жить: живут живет живущих живем живешь живу жили жить
ген: гены ген генах генов
несоответствие: несоответствия
невроз: неврозам неврозом
падение: падения падении падению
суицид: суициду суициде суицидов
строгий: строгом строгие строгих строгой строгий
изо: изо
французский: французский французское
респондент: респондентов
обмен: обмена обмен
садиться: садятся садится
потреблять: потребляемым потребляет потребляемых потреблять
адаптироваться: адаптироваться
метаболизм: метаболизм метаболизма
замедляться: замедляется
худеть: худеть худеешь
срываться: срывается
возвращаться: возвращается возвращаюсь возвращаются
привыкнуть: привыкли привык привыкла привыкнуть
булимия: булимии булимией булимия
набор: наборы набору наборе набором набора наборах набор
картошка: картошке картошка
старый: старые старая старых
некрасивый: некрасивая
стволовой: стволовые
нить: нити
паралич: параличом параличе
дыхание: дыхания дыхании дыхание
увеличиться: увеличилось увеличилась
министерство: министерство
предупреждать: предупреждали предупреждает
упругость: упругость
эластичность: эластичность
рубец: рубцы
рисковать: рисковать
повернуть: повернуть
вспять: вспять
лицензия: лицензии лицензия
разрешение: разрешения разрешение
талия: талию
пухлый: пухлые
фигура: фигуры фигурой
песочный: песочные
супермодель: супермодель
выдающийся: выдающиеся
ягодица: ягодицы ягодиц
имплантат: имплантатами имплантаты имплантатов
недооценивать: недооценивают
отточить: отточен
волчанка: волчанка
оказывать: оказывает оказывают оказывать
обучать: обучающие
отмирание: отмирание
погоня: погоне
понятие: понятие
относительный: относительное
недовольный: недовольна недоволен
вставить: вставила
любоваться: любовалась
замечать: замечаешь замечать замечаем замечаю
изменчивый: изменчивые
отрезать: отрежут
каре: каре
устроиться: устроиться
мечта: мечту мечта мечты
встретить: встретить
непреодолимый: непреодолимое непреодолимая
половина: половина половиной половины половину
характерный: характерно характерна характерны
злоупотребление: злоупотребление злоупотреблении злоупотребления
наркотический: наркотическим
отмена: отмены
корень: корней корни корнем корень
зло: зла
обстановка: обстановке обстановка
воспитывать: воспитываем воспитывают воспитывает
зависимый: зависим зависимые
принадлежность: принадлежность принадлежности
примкнуть: примкнуть
сопоставимый: сопоставимых
миг: миг
наркотик: наркотиков наркотика наркотики наркотиками
ореол: ореол
привлекательность: привлекательности
установка: установкой установка
ломка: ломка
животное: животных животные животного животными
азартный: азартные азартная
успешно: успешно
ущерб: ущерб
база: базой база базы базу базе базам
перегибать: перегибать
быстрый: быстрая быстрых быстрое быстрый быстрой быстрого
снизиться: снизиться снизилось снизится снизилась
ослабнуть: ослабнет
темперамент: темперамента темпераментом темпераменту темпераментам темперамент темпераментов темпераменты темпераменте
темпераментный: темпераментный
синоним: синоним
стабильный: стабильны стабильными стабильным
подсчитать: подсчитать подсчитали
генетика: генетике генетика генетикой генетики
чёткий: четкой четких четкое четкая
схема: схема схему схемы
специфический: специфические специфических специфический
черта: черта черты черт
характер: характера характер
вариация: вариации
самодисциплина: самодисциплину
осторожность: осторожность
общительность: общительности общительность
среда: среда среды среде среду
отчасти: отчасти
эра: эры
греческий: греческий
философ: философ
типология: типологию
весёлый: веселое веселые веселым веселую веселый весело
жёлчь: желчь желчи
меланхолический: меланхолический
жёлтый: желтыми желтый желтых желтого желтая желтой
флегматичный: флегматичный
несмотря: несмотря
столетие: столетий
советский: советский советского
наблюдать: наблюдала наблюдаю наблюдая наблюдать наблюдали наблюдаемый
лаборатория: лаборатории лаборатория
сходный: сходный
неуравновешенный: неуравновешенное
уникальный: уникальным уникальная уникальный уникальное уникальных уникальными
неверный: неверно неверным неверное
общительный: общительный общительному
застенчивый: застенчивого застенчивый
настойчивость: настойчивости
робкий: робкий
отзывчивость: отзывчивость
знак: знаки знакам знак
настойчивый: настойчивых
экстраверсия: экстраверсия
доброжелательность: доброжелательности доброжелательность
невротизм: невротизм
возбуждаться: возбуждаются
экстраверт: экстраверта экстравертов экстравертом экстраверты экстраверт
интроверт: интровертов интроверт интроверты интровертами интровертом
путать: путать
подстраиваться: подстраиваться
атеист: атеистов атеистам атеисты
фобия: фобия фобиями фобии фобий
откровенно: откровенно
кресло: кресле
палата: палате
герой: герои героев
бот: бот
почта: почте почты почту
эфир: эфире
запись: запись записью записи
двойня: двойня
приговор: приговор
донор: донор донора донорами доноры доноров донором донору
трейлер: трейлер
добро: добро
избрать: избранные избранное
просмотреть: просмотрели просмотреть просмотренных
объявление: объявления объявление
пользователь: пользователю пользователь пользователи пользователе пользователях пользователем пользователей пользователя пользователями пользователям
житель: жителям жителей
обновление: обновление обновления обновлений обновлении
оптимизировать: оптимизированы
автомобиль: автомобилей автомобиле автомобиль автомобиля
удобный: удобно удобным удобнее
эксперт: эксперта эксперты экспертов экспертом эксперт экспертами
сообщение: сообщения сообщений сообщение
пункт: пунктам пунктов пункта пункту пунктом
станция: станция
график: график
апелляция: апелляция
номер: номер номером
звонок: звонков звонки
океан: океаном океан океаны
жилой: жилые
река: рек
локальный: локальным локальный
титульный: титульными
местоположение: местоположением местоположения местоположение местоположений местоположении
хронология: хронология
метка: метке
горчичник: горчичники горчичников
бесполезный: бесполезным бесполезный бесполезных бесполезные бесполезно бесполезны
доказать: доказать доказан доказали доказана доказано доказаны
тюбаж: тюбаж
декабрь: декабря декабре
применение: применении применение применению применений применения
древесный: древесными древесное
мощный: мощный мощные мощными
антиоксидант: антиоксидантами антиоксидант антиоксидантов антиоксиданты
радикал: радикалами радикалов
рубеж: рубежом
противоречивый: противоречивы противоречивые
экстракт: экстрактов экстракт экстракта экстрактом экстракты
вступать: вступают вступает вступать
антикоагулянт: антикоагулянтов
разжижать: разжижающих
различный: различные различными различных различным
капсула: капсулы капсула
дедушка: дедушка дедушкам
голос: голоса голосом голос
ход: ход ходе
измерять: измеряет измеряют измерять
наступить: наступит наступило
зачатие: зачатием зачатия зачатию зачатии
хромосома: хромосомой
надпочечник: надпочечников
лечить: лечите лечат лечили лечить лечит
дина: дина
педиатр: педиатром педиатры педиатр
комедийный: комедийных
остин: остина
военный: военный
агент: агента
шведский: шведский
насос: насос насосом
цилиндр: цилиндра цилиндр
помещаться: помещается
продолжительный: продолжительной
вручную: вручную
нагреваться: нагреваются нагревается
кольцо: кольца кольцо
удерживать: удерживающие удерживать удерживают
эксплуатация: эксплуатации эксплуатация
относительно: относительно
стоимость: стоимость стоимости
гибкость: гибкость
вовремя: вовремя
приобретать: приобретают приобретайте
навсегда: навсегда
продолжительность: продолжительность продолжительностью
предпочтение: предпочтение предпочтения предпочтениями предпочтений предпочтениях
ручной: ручной ручную
гидравлический: гидравлическую
качественно: качественно
дырка: дырок
обещать: обещают обещанный обещаем
обман: обман
кнопка: кнопок кнопку кнопка
вакуум: вакуум
подождать: подождите
дискомфортно: дискомфортно
обхватить: обхватите
опционально: опционально
маска: маски масках маска маске масок маску маской
просить: просит прошу просили просим
удачный: удачных
расставаться: расстается
дизайнер: дизайнеров дизайнеры дизайнер
упасть: упал упадет упала
случайно: случайно
желать: желать
след: следы следов
охарактеризовать: охарактеризовала
мечтать: мечтаю мечтать мечтала
изъян: изъяна
проводник: проводником
отражение: отражении отражением
желанный: желанной желанному
полка: полке полках полку
опробовать: опробовав
добиться: добиться
впервые: впервые
поверхность: поверхность поверхности
чистый: чистую чистым чистая чистой чистых чистого
очевидный: очевидным очевидные
обещание: обещания
диск: диска дисков диск
сыворотка: сыворотка сыворотку сыворотки
прекрасный: прекрасный прекрасное
гладкий: гладкого гладкая гладко
искренний: искреннюю искренней искреннее
смочить: смочена
добросовестно: добросовестно
эмульсия: эмульсии эмульсией
буквально: буквально
напитать: напитанная
влага: влагой
сиять: сияющая
плотный: плотных плотным плотная плотный плотные
интуиция: интуиция
шептать: шепчет
спирт: спирт спирта
восстанавливать: восстанавливающего
лифтинг: лифтинг
аналогичный: аналогичное аналогичные аналогичного аналогичными аналогичная
арсенал: арсенала
претензия: претензий
мазь: мазью мазь
ладно: ладно
ненавязчивый: ненавязчивую
блестеть: блестят блестящую блестит
блин: блин
масленица: масленицу
игристый: игристого
спасти: спасти спасет спасут
едкий: едкого
надоесть: надоели
тусклый: тусклый тусклое
взяться: взялся взяться
единственный: единственным единственная единственный единственные единственное
супермен: супермена
аналог: аналоги аналогом аналогов аналог
претендовать: претендует
кислород: кислород кислорода кислородом
жёсткий: жесткий жесткой жесткую жестких жестким
умственный: умственная умственному умственных
изнеможение: изнеможения изнеможению
вставлять: вставлять
меланома: меланомы
аз: азов
ультрафиолетовый: ультрафиолетовые ультрафиолетового ультрафиолетовый ультрафиолетовых
город: городе городах городом города
минеральный: минеральные минеральными минеральной минеральный минеральных минеральная
судьбоносный: судьбоносная
встреча: встречу встреч встречи встреча
бизнес: бизнеса бизнесе
привезти: привезти
собираться: собираюсь собираются собирается
аппаратный: аппаратными аппаратным аппаратное
фильтр: фильтрах фильтров фильтр фильтрами фильтра фильтры
забыть: забыли забудьте забуду забудет забытых забыть забытую
брать: беру берет берут берите брала берем брать брал
побольше: побольше
фишка: фишка
заявлять: заявляет
диоксид: диоксида диоксид
оксид: оксиде оксид
общепризнанный: общепризнанные
поглощать: поглощает поглощают
пляж: пляж пляжи пляжа
море: море
четверть: четверть
течь: течь течет
пятнадцать: пятнадцати
грядущий: грядущей грядущее
приветствовать: приветствуют
велеть: велят
активно: активно
фотон: фотон
проскочить: проскочил
десерт: десерты десерт
бежевый: бежевого бежевый
пигмент: пигмент
впереди: впереди
поверх: поверх
ложиться: ложится ложатся ложитесь
держаться: держаться держатся
шоколадный: шоколадный шоколадного
каменный: каменном каменных
колоть: колют
гаджет: гаджет гаджеты гаджетов
протокол: протокол протоколов протокола протоколы
бежать: бежать
горе: горя горем горе
тонометр: тонометру тонометр
рознь: рознь
подогрев: подогрев
сидение: сиденья
термин: терминам термины термин
сегодняшний: сегодняшний
медсестра: медсестер
выборка: выборка выборках выборке
существенный: существенные существенное существенных
симуляция: симуляцией
клитор: клитор клитора клитору
насыщение: насыщения насыщение насыщению насыщением
четвёртый: четвертый
предыдущий: предыдущую предыдущие предыдущий предыдущей предыдущего
дойти: дойти
аналогия: аналогию аналогии
щекотать: щекочет щекотать щекочут
чихать: чихаешь чихать
отпускать: отпускает
испытать: испытать
мини: мини
удивить: удивило удивил
лёгкость: легкостью
напрягаться: напрягаться
договориться: договорились договориться
повторить: повторить
релаксация: релаксацию релаксации
передышка: передышки
существование: существование существовании
интервал: интервалом интервалу
единичный: единичное
немало: немало
облегчить: облегчить
понимание: понимание понимания понимании
ключ: ключом ключи ключ
возбуждать: возбуждают возбуждал
жара: жары жарой жаре жару
удар: удара ударов удар ударам удару ударе
позитив: позитив
пандемия: пандемию пандемии
пресс: пресс
секретарь: секретарь
президент: президента
бейдж: бейдж
порошок: порошка порошок порошков
хлор: хлора
дезинфицировать: дезинфицирующее
чудо: чудо
жижа: жижа
чистотел: чистотел
мыло: мыла мыло
духи: духи
антисептик: антисептикам антисептиком антисептиков антисептиками
артистка: артистка
спасение: спасения спасение
дополнение: дополнение дополнениями дополнений дополнения
сплошной: сплошной
клиент: клиентам клиентов клиентом
впитываться: впитывается впитываться
плёнка: пленка пленки пленку
промокнуть: промокшая промокнуть
излишек: излишки излишек
понравиться: понравиться понравился понравится понравилась
мастер: мастерам мастера мастер
ухоженный: ухоженная
рекомендоваться: рекомендуется
перец: перца перец перцем
ромашка: ромашку ромашки ромашка
холод: холода холоде холодов холод
сохнуть: сохнуть
доходить: доходит
значение: значение значений значения
полюбить: полюбили полюбила
янтарный: янтарный янтарная
взаимодействие: взаимодействия взаимодействие взаимодействии
ветер: ветром ветру ветра
мокрый: мокрыми мокрые
полчаса: полчаса
осенить: осенило
взгляд: взгляда взгляды взгляд
природный: природный природные природным природного
первобытный: первобытным первобытный
дикий: диким
знакомиться: знакомиться
странный: странные странное странно странным странного странный
композиция: композиция
пепел: пепел
крыло: крылья
мотылёк: мотыльков
имитация: имитацию
скраб: скрабов скраб скрабы
тщательно: тщательно
хит: хит хиты хита
модный: модный модное модные модных модного
гель: геля гелем гелей гели гель
лак: лаками лаки лака лаков лаком лак
глина: глины
варежка: варежек
азбука: азбука
квадратный: квадратные
уравнение: уравнения
выстраивать: выстраивать
расставлять: расставлять
жизненный: жизненный жизненные жизненная
групповой: групповая групповым групповую групповой
попасть: попадет попасть попала попали
юридический: юридические юридическое юридическому юридического юридический
верно: верно
работник: работника работников работники работникам работник
подход: подходах подход подходе подходов
формально: формально
образовательный: образовательные образовательная
разделение: разделение
навык: навыка навыков навык навыки навыками
динамический: динамические
разворачиваться: разворачивается
сочетать: сочетает сочетающие
соотношение: соотношении
элемент: элементов элементах элементам элементами элемент элементы
эмиграция: эмиграции
строго: строго
задуматься: задуматься
проработать: проработать проработали
общение: общения общением общение общении
присоединиться: присоединился присоединиться
походить: походить
аккуратно: аккуратно
таблица: таблице таблицу
сосредоточить: сосредоточено сосредоточен сосредоточить
коммуникация: коммуникации коммуникация коммуникацию
общность: общность
темп: темпе темп
гибкий: гибкое гибкими гибких гибкий гибким
альянс: альянс
бережный: бережное бережной бережный бережным
реальный: реальные реального реальной реально реальном реальных реальный
сменить: сменить сменил
вектор: вектор
подводный: подводные
камень: камнями камень камня камни камней
достоинство: достоинств
ведущий: ведущий
нарушить: нарушить нарушил нарушена
потеряться: потеряться
распространяться: распространяется распространяются распространяться
усилие: усилие усилия усилиями усилий
анкета: анкету
отличный: отличным отличные отличных отличное отлично отличный
отталкиваться: отталкиваться
ошибиться: ошибиться
алкоголизм: алкоголизм алкоголизмом алкоголизма
поздний: поздних поздний позднем поздние
социум: социума социум
шизофрения: шизофрения
челюсть: челюсть челюсти
овал: овала овал
подбородок: подбородка подбородок
нести: несет нести несут
соревноваться: соревнуются
звание: звание
выразительный: выразительного
неинвазивный: неинвазивный
изобретатель: изобретатель
резиновый: резиновый резиновых
шарик: шарик
владелец: владельца
кусать: кусала кусают кусать
грызть: грызть
сопротивление: сопротивлением сопротивление
передний: передней передними
исчезать: исчезает
восстановиться: восстановился восстановится восстановиться
необоснованный: необоснованной необоснованным
прикус: прикуса прикусом прикус
обыкновенный: обыкновенной
опасение: опасений
многогранный: многогранный
хранение: хранение хранения
пожелание: пожелания пожеланиями пожеланий
ценность: ценностей ценность ценностям ценности
высококачественный: высококачественные
колбаса: колбасы
смертельно: смертельно
смысл: смыслах смыслы смысле смыслу смысл смыслом смысла
рациональный: рационального
тарелка: тарелок тарелку тарелки
официальный: официальный официальные официальных официальном официальным
критерий: критериями критерия критерием критерии критериям критерий критериев
грозить: грозит
срок: сроках сроке сроки срок срока сроками
ингредиент: ингредиентов ингредиент ингредиентам ингредиенты
типа: типа
девять: девять девяти
модифицировать: модифицированные
внести: внесенные внести внесены
технология: технологии технологий
генный: генной
беспокоиться: беспокоиться
избежать: избежать
хищник: хищников
пищеварение: пищеварением пищеварение пищеварения пищеварении
борщ: борща
посуда: посуды посудой посуду
фольга: фольгу фольги
водоросль: водоросль
пшеница: пшеницы
фуфло: фуфло
микроволновка: микроволновки микроволновке
суша: суши
обезжиренный: обезжиренные
наволочка: наволочка
гипноз: гипнозом гипноз
лампа: ламп лампы лампе лампой
избавлять: избавляют
ксенон: ксенон
лор: лором лор
прессотерапия: прессотерапия
арбуз: арбузы арбуз
развод: развод разводов развода
пояс: поясу пояс
похудеть: похудеть
лезть: лезть лезут
кошка: кошки кошку кошка кошек
греть: греет греть
пептидный: пептидные
глицин: глицин
генитальный: генитального генитальные
элеутерококк: элеутерококк
сопля: соплей сопли
вывести: вывести выведут выведенную
мельдоний: мельдоний
кефир: кефир
интерферон: интерферон
сетка: сетка
чага: чага
серебро: серебро
звёздочка: звездочки звездочка
грипп: грипп гриппа гриппом
костный: костной костные костно костного
импульс: импульсы импульсов
облегчать: облегчает облегчают облегчая
сердечный: сердечное сердечных сердечно сердечный сердечной сердечного
ритм: ритма ритм ритмы
рубль: рублей
литр: литра литр литре
утконос: утконосе
донат: донат
дороже: дороже
бутылка: бутылок бутылку бутылка бутылки бутылке
ессентуки: ессентуки
боржоми: боржоми
добывать: добывали добывают
ускорять: ускоряет ускоряют ускорять
этикетка: этикетке
сердцебиение: сердцебиение сердцебиения
понизиться: понизиться
затрудниться: затрудниться
экспериментировать: экспериментировать
стакан: стакане стакан стакана стаканов
остаток: остатки
абсорбция: абсорбцию
конечный: конечном конечную
особенный: особенные особенной особенных особенными особенного
шпинат: шпинат
хлеб: хлеб хлебу хлебом хлеба
преувеличить: преувеличить преувеличена
обогащать: обогащают
растворять: растворяет растворять
золото: золото золота
необычный: необычный необычной необычные
уточнять: уточняет
хватить: хватит
питьевой: питьевые питьевой
очищение: очищение
выравнивание: выравнивание
осветление: осветление
линейка: линейка линейки линейку линейке
зрелый: зрелых зрелой
борьба: борьбы борьбе борьба борьбу
тонус: тонуса тонус тонусе
серия: серии серию серия
регенерация: регенерация
мегаполис: мегаполиса
гладкость: гладкости гладкость
блеск: блеска
афродизиак: афродизиак
равновесие: равновесия равновесие
основное: основное
коллекция: коллекции коллекция
акция: акций акциях акция акции
избранный: избранное
гейзер: гейзеры
каталог: каталог
корзина: корзину корзина
комплексный: комплексная комплексный
белый: белых белыми белая белым белого белые белом белую белый белой
липкость: липкость липкости
алоэ: алоэ
зелёный: зеленого зеленый зеленые
укреплять: укрепляемые укрепляет укрепляющее
ши: ши
питать: питаю питает
смягчать: смягчает смягчают
барьерный: барьерные барьерную барьерных
мята: мятой мяты мята
охлаждать: охлаждать охлаждает
компонент: компонентов компонент компоненты компонента компоненту
глицерин: глицерин
алкил: алкил
салицилат: салицилат
бутил: бутил
луговой: луговой
камедь: камедь
наружный: наружного
хранить: хранить хранит хранящий
поколение: поколению поколений поколение поколении поколения
разлагаться: разлагаются
превосходно: превосходно
атриум: атриум
ангара: ангара
награда: награды награда
контрактный: контрактное
эксклюзивный: эксклюзивные
предоставлять: предоставляет предоставлять предоставляем предоставляя предоставляемую предоставляемых
покупатель: покупателями покупателей покупателя покупатель покупатели покупателем покупателям
регистрация: регистрации регистрация
обязательство: обязательств
аудит: аудита
фамилия: фамилию фамилия
отчество: отчество
дата: дату даты дата
контактный: контактный контактной контактными контактно контактная контактным контактном контактные
электронный: электронные электронный электронной электронных
исключительно: исключительно
исключение: исключением исключение исключения
исполнение: исполнением исполнение
продавец: продавцом продавцу продавца продавец
уполномочить: уполномоченных
реализовывать: реализовывать
транзакция: транзакции транзакциях
противоречить: противоречат
настоящий: настоящей настоящих настоящем настоящего настоящим
федеральный: федеральный федерального федеральным
контроллер: контроллером контроллер
территория: территории территориях территорий
регламент: регламента
единица: единицу
документ: документа документы документах документов
домен: домену домен
ответственность: ответственность ответственности ответственностью
юр: юр
размещать: размещаемые размещает
планшет: планшете планшетах
положение: положений положениями положения положением положение положении
сбор: сборе сбора сбор
согласный: согласен согласны
немедленно: немедленно
раскрыть: раскрыть раскрыты
договор: договор договором договора
трансграничный: трансграничной
обжаловать: обжаловать
бездействие: бездействия бездействие
уполномоченный: уполномоченный
субъект: субъекту субъекта субъектов
возмещение: возмещение
компенсация: компенсацией компенсацию
охрана: охраны охрану
перечень: перечень
трафик: трафика трафике
совершить: совершенных совершить
вход: входа входе вход входом
профиль: профилем профиле профиля профиль профили
переписка: переписку переписки
заказ: заказов заказах заказом заказы заказ
оплатить: оплаченных
объединение: объединения
полнота: полноту
осуществлять: осуществляющим осуществлять осуществляющие осуществляют осуществляет осуществляющее
корректировка: корректировка корректировку
предоставить: предоставила предоставлена предоставили предоставленные предоставленный предоставлено предоставить
собственник: собственника
банковский: банковским банковского банковской
мошенничество: мошенничество мошенничества
соответствующий: соответствующей соответствующее соответствующих соответствующие соответствующими
учреждение: учреждением учреждении учреждения учреждение
ведение: ведения
посещение: посещений
выводить: выводимых выводит выводить
идентификация: идентификация идентификации
технический: техническая технических технические технической
функциональный: функциональных функциональная функциональной функциональным функциональные
предотвращение: предотвращения предотвращение
выявление: выявления выявлению
влечь: влечет
зайти: зайти
функциональность: функциональности
добросовестность: добросовестности
заранее: заранее
заблаговременно: заблаговременно
опосредованно: опосредованно
автоматизация: автоматизации
сервис: сервисов сервисом сервисами сервисах сервисы сервису сервис сервисам
идентифицировать: идентифицировать
аналитический: аналитических аналитическая аналитическую
размещение: размещение
иной: иной
выразить: выраженный выраженной выражено выразить
возражение: возражение
аккаунт: аккаунте аккаунт аккаунтом аккаунта аккаунту
несовершеннолетний: несовершеннолетними несовершеннолетний
законный: законные законного законных
представитель: представителя
паспорт: паспорта
союз: союза союзы
государство: государство государства государств
разумный: разумного разумных
истечение: истечению
уничтожить: уничтожить
уничтожение: уничтожение уничтожения
перенос: перенос
ознакомление: ознакомления
иностранный: иностранный иностранная иностранного
предел: пределах предел пределами
расхождение: расхождения
оригинал: оригинала
перевод: перевода перевод
спасибо: спасибо
скидка: скидках скидка скидкой
качественный: качественная качественных качественные качественную
приниматься: приниматься принимаются
самообразование: самообразование
коронавирус: коронавирусе коронавируса коронавирусу коронавирусом
распространение: распространения распространение распространением
английский: английском английский английского
врачебный: врачебных врачебные врачебной
публиковать: публиковать публикуют
топовый: топовых
версия: версия версию версии версий
испанский: испанском
онлайн: онлайн
переводчик: переводчик
переводить: переводить переводите
приличный: приличный
отбирать: отбирают отбирает
ясный: ясно
вероятный: вероятней вероятно
скрывать: скрывают скрывать
беспристрастность: беспристрастности
гепатит: гепатита гепатит
устареть: устаревшим устаревших
расставить: расставить расставлены
список: список списке списки списком
некоммерческий: некоммерческие некоммерческой некоммерческих
ошибаться: ошибаться
доверять: доверяйте доверяют доверяет доверять доверяете
субъективный: субъективные субъективными
легитимный: легитимны
умалчивать: умалчивают умалчивает
неправда: неправда
британский: британского британской
служба: служба службой службу службы
бесплатный: бесплатной бесплатная
плашка: плашки
повестись: повестись
фейк: фейк
внимательный: внимательны
значительно: значительно
популярность: популярность популярностью популярности
биология: биологии биологию
массив: массива
руководство: руководства руководстве руководство руководством руководствах
позиция: позиция позицию позиции
внимательно: внимательно
подделывать: подделывают
критично: критично
подолгу: подолгу
зарубежный: зарубежные зарубежных
авторитетный: авторитетными авторитетным
профессиональный: профессиональных профессиональный профессиональная профессиональным профессиональные профессионального
блогер: блогеры блогера блогером блогерами блогеров блогер
осторожный: осторожны осторожными
упирать: упирает
достоверность: достоверности
упомянуть: упомянутом упомянутые
комиссия: комиссии комиссия
самолечение: самолечение
подделка: подделка
катастрофа: катастрофы катастрофа катастрофой
разоблачить: разоблачил
минус: минусы минус
запугивать: запугивает
мошенник: мошенников
перепутать: перепутать
марка: марки марка марок
органический: органический органические органических органического
стабильность: стабильности
выбеливать: выбеливает выбеливают
дерматит: дерматит дерматите
слизистая: слизистой
патч: патч патчи
шея: шеей шея шеи шее шею
соединение: соединения соединений
накапливаться: накапливаются накапливается накапливаться
академия: академия академии
медикамент: медикаментов медикаменты
бездоказательный: бездоказательные
скопление: скоплением скопление
стареть: стареет стареть стареют старела
маркировка: маркировки
азиатский: азиатских
треть: треть трети
банк: банк банков банками банке
трава: трава травами трав травой
толстый: толстой толстыми толстым
смывать: смывать
гидрофильный: гидрофильными гидрофильным
загадка: загадка
флюид: флюид флюиды
полоса: полос полосы
тяжело: тяжело
лимон: лимон лимоном
календула: календулы календула
лаванда: лаванды
лечь: лечь лег
груз: грузом
ломаться: ломается ломаются
озон: озоном озоне
неплохо: неплохо
очки: очки
рубашка: рубашки
длинный: длиннее длинным длинные длинном
рукав: рукавом
однозначно: однозначно
атаковать: атаковать атакует
уязвимый: уязвимым
погибнуть: погибнут погибнуть погибла
сигнализировать: сигнализируют сигнализировать сигнализирует
критический: критические критическом
незащищённый: незащищенный незащищенном
презерватив: презерватива презерватив презервативов презервативе презервативы
мать: матери матерей
огромный: огромный огромное огромную огромной
прорыв: прорыв
эпидемия: эпидемии
приверженность: приверженности приверженность
параллель: параллели
капельница: капельницу
родить: родила рожденных родить
прохождение: прохождением прохождении прохождение
исход: исход исходов исхода
оппортунистический: оппортунистические
кандидоз: кандидоз
одинаковый: одинаковой одинаковые одинакового
детальный: детальное детальную
акушер: акушером акушеры
пристальный: пристальное пристального
тромбоцит: тромбоцитов
рационально: рационально
стабильно: стабильно
алгоритм: алгоритм
предпочитать: предпочитаем предпочитает предпочитают
нулевой: нулевая нулевые нулевым
составлять: составляющих составляет составлять
минимизировать: минимизировать
стопроцентный: стопроцентного стопроцентной
южный: южной южного
приверженный: привержена
абсолютный: абсолютное абсолютном абсолютная
иллюзорный: иллюзорный
заменитель: заменителей заменители
перенаправить: перенаправить
больница: больница больницах больницу больницы
повторно: повторно
учёт: учет учетом
наблюдение: наблюдения наблюдением
назначение: назначения назначению
манипуляция: манипуляции манипуляций
радостный: радостное радостных радостным
неожиданный: неожиданное неожиданная неожиданного
выносить: выносить
эмбрион: эмбрионами эмбрион эмбриона эмбрионов эмбрионы
искушение: искушению
поспать: поспать
постель: постели постель
лень: лени лень
стимул: стимул стимулов
диван: дивана диван
лыжа: лыжах лыж лыжи
снег: снег снегу снега
прикрепить: прикрепленных
ботинок: ботинки ботинкам
палка: палок
местность: местность местности
задействовать: задействовать задействована задействованы
бедро: бедер бедро бедрах бедра
новичок: новички новичок
сжечь: сжечь
порадовать: порадовать
сноуборд: сноуборд сноуборде
экстремальный: экстремальный экстремальных
прыжок: прыжках прыжки прыжков
доска: доску доске
мастерство: мастерству мастерство
корпус: корпус корпуса
конёк: коньки коньках
покрытие: покрытия покрытие покрытий покрытиях
колено: колени колено коленях
лодыжка: лодыжка лодыжки
стиль: стиле стиля стиль стилями стилем
бицепс: бицепсы
прикреплять: прикрепляет
лодочка: лодочек
площадь: площадь площади
рыхлый: рыхлого
сжигать: сжигать сжигаем сжигает
координация: координацию
природа: природа природе природы природой
рельеф: рельеф рельефами
адаптация: адаптация адаптации
смело: смело
ускорение: ускорению
усердный: усерднее
заняться: заняться
сокращаться: сокращаться
активизировать: активизируют
госпитализация: госпитализаций
хандра: хандру хандры хандра
развлечение: развлечение развлечения
бобслей: бобслей
снеговик: снеговиков
напоследок: напоследок
экипировка: экипировку
вентилировать: вентилируемую
терпеть: терпеть
немецкий: немецкого немецкая немецкой
гласить: гласит
хвастаться: хвастается
местный: местному местную местной местные местных
премия: премия премии премию
лидер: лидеру лидеры
премировать: премировали
победитель: победителей
звёздный: звездные
гельминт: гельминтами гельминтов
летальный: летальный
предостерегать: предостерегает
ветеринария: ветеринарии
адаптировать: адаптированы адаптирую адаптирован
глобальный: глобальные глобальных
район: районах
бледный: бледный
лейкоцит: лейкоцитов
заражение: заражения
подчёркивать: подчеркивают
необходимость: необходимостью необходимость
тщательный: тщательного
убедиться: убедилась убедиться
попа: попой попу попе
приклеивать: приклеивали
скотч: скотч
матч: матча
сходство: сходства
пикантный: пикантными
сорт: сорт сорта
тень: тени
дешёвый: дешевый
позднее: позднее
горький: горького горькой горькими горький горькие
добавление: добавлением добавления добавление
смузи: смузи
банан: бананы банан
манго: манго
клубника: клубнику
блендер: блендере
фиолетовый: фиолетовыми
клиновидный: клиновидными клиновидный
метр: метров
высота: высоты высоту
захватывать: захватывая
сорняк: сорняка
выживать: выживать выживают выживает
древность: древности
мука: мука муки муку
алкогольный: алкогольном алкогольных
релевантный: релевантных
положить: положите положить
чайник: чайник
полотенце: полотенцем полотенца
известность: известность
гречиха: гречиху гречихи гречихе гречиха
обжаривать: обжаривают
ярко: ярко
овсяный: овсяным
кровообращение: кровообращению кровообращения кровообращением кровообращение
гречка: гречку гречка
класс: классов класса
выращиваться: выращивается
татарский: татарская татарскую татарской
остров: острове
жасминовый: жасминовый жасминового
цветок: цветком цветков цветка цветы
жасмин: жасмина жасмин
заварка: заварку
залить: залить залили
кипяток: кипятком кипятке
ядовитый: ядовитое ядовиты
кувшин: кувшин
графин: графин
уснуть: уснуть
уменьшать: уменьшает уменьшают
постоять: постоять
бонус: бонусом бонус
воображать: воображать
воображение: воображении воображением воображения
ненормальный: ненормальные ненормального
подчинение: подчинением подчинение
доминирование: доминирование
подчиняться: подчиняться
тренд: тренд тренду трендов тренды тренде тренда
порнография: порнографию порнография порнографии
актёр: актер актера актеры актеров
наверное: наверное
любитель: любителями любителей
волновать: волнуют
одежда: одежда одежду
подглядывать: подглядывать
нетипичный: нетипичными
чей: чье чьи
просвещение: просвещения просвещением
сексология: сексология
медведь: медведе
выкинуть: выкинуть
отодвинуть: отодвинуть
вживую: вживую
издалека: издалека
зачастую: зачастую
водопад: водопады
бытовой: бытовом бытовых
банальный: банальная
сбивать: сбивает
брак: браке брака
страстный: страстной страстный страстная
нечестный: нечестно
крайний: крайнюю крайняя крайней
бывший: бывший бывшего
отвращение: отвращение
знаменитость: знаменитости знаменитостей
воздействовать: воздействует воздействовать воздействуют
импульсный: импульсным импульсный
видимость: видимость
вернуть: вернуть
защитник: защитника защитник
преждевременный: преждевременную преждевременного
аспект: аспект аспекты
селективный: селективного
мишень: мишени мишенями
клеточный: клеточного клеточной клеточном
структурный: структурном
диапазон: диапазона диапазонов диапазон диапазоне диапазоны
нанометр: нанометров
разрушаться: разрушаются разрушается
пропадать: пропадает пропадают
отобрать: отобрали
снимок: снимков снимки
слепой: слепой
угорь: угрями
антибиотик: антибиотик антибиотиков антибиотиками антибиотики
выработать: выработать
агентство: агентство
ядерный: ядерной
квалифицированный: квалифицированный
аксессуар: аксессуарах аксессуары аксессуар аксессуаров
юрисдикция: юрисдикции
штат: штата штате штаты
регулирование: регулированию регулирования
фермент: ферменты ферментов
производить: производит производят производить
профессия: профессий профессию
найтись: найтись
отклонение: отклонения
мотивировать: мотивирует
биоматериал: биоматериалы биоматериалов
анонимность: анонимность
портрет: портрет
острый: острая острый острое острым острую острых острого острой острые
соус: соусов соуса соус
наесться: наесться
глядеть: глядя
лишний: лишний лишнее лишнего лишние лишним лишних
гулять: гуляли гулять гуляя
подавить: подавить подавлен
секунда: секунд
сытый: сыты сытыми
изображение: изображения изображений изображение
поесть: поел поесть
руководить: руководящую руководивший
смочь: сможем сможете смогла смогли смог
оранжевый: оранжевого
съедать: съедать съедали съедают
видение: видение
разноцветный: разноцветные разноцветными
неоднократно: неоднократно
цифровой: цифровое цифровому
голодный: голоден голодный голодном
виртуальный: виртуальной виртуальном виртуальные виртуального
знакомство: знакомствам знакомство
усугублять: усугубляет усугублять
фотографировать: фотографировать
ресторан: ресторанах ресторана ресторане
повар: поварам
аппетитный: аппетитных
дразнить: дразнящие
намного: намного
невнимательность: невнимательность
посылать: посылать
торопиться: торопится торопиться
отвлекать: отвлекающих отвлекающие
чтение: чтение
кофейня: кофейни
стоять: стоят стоял стоять стояли
нездоровый: нездоровых нездоровое
поправиться: поправиться
ногтевой: ногтевая ногтевой ногтевого ногтевом
пластина: пластина пластине пластины
отслоение: отслоение
ложа: ложа
изменяться: изменяется
псориаз: псориазом псориаз псориаза
заразный: заразен заразнее заразно
бассейн: бассейном бассейнах бассейн бассейне
ложе: ложе
внешне: внешне
напоминать: напоминает напоминающие напоминаю напоминая
рог: рог
подрезать: подрезал подрезать
тесный: тесной
сдавливать: сдавливает
старость: старость
предрасположенность: предрасположенность
тяжесть: тяжести тяжесть
койлонихия: койлонихия
железодефицитный: железодефицитной
концевой: концевой
фаланга: фаланги
выпуклый: выпуклыми
изогнутый: изогнутыми
палочка: палочек
безвредный: безвредны
углубление: углубления
экзема: экземой экзема
продольно: продольно
алопеция: алопеция
лишай: лишай
спонтанно: спонтанно
исчезнуть: исчезнут исчезнуть исчез
бо: бо
временно: временно
прекращаться: прекращается
скарлатина: скарлатина
корь: корь
поразить: поразила поражены пораженные
отслаиваться: отслаиваются
лёгкое: легких легкие
гастроэнтеролог: гастроэнтеролог
нация: нации
китайский: китайской
вьетнамский: вьетнамской
индийский: индийской
богато: богато
разнообразие: разнообразие разнообразия
подкупать: подкупает
липид: липиды липидов
взять: взяли взять взял возьми взяла возьму
брокколи: брокколи
капуста: капуста капусты
горошек: горошек
руккола: руккола
салат: салат салата
тофу: тофу
соевый: соевого соевый
креветка: креветки
устрица: устрицы
амарант: амарант
лен: лен
кунжут: кунжута кунжут
миндаль: миндалем миндаль
кешью: кешью
финик: финики
сушёный: сушеные
вдохновлять: вдохновляющие
успешный: успешная успешны успешного успешными успешном
пообщаться: пообщался пообщаться
замечательный: замечательно замечательными
развеять: развеять развеет
трата: трата
правый: правую правы правом прав
ожидать: ожидать
гарантировать: гарантирует гарантировать
пункция: пункция пункции
замереть: замершая
опустить: опустила
двойняшка: двойняшек
жалеть: жалею жалеть
поход: походов поход походы походах
ава: ава
московский: московские московской московском
стандартный: стандартные стандартных стандартный стандартную стандартная
щадить: щадящая
ухудшиться: ухудшиться ухудшился
испортиться: испортилась
выпадать: выпадать выпадают
переживать: переживали переживает переживать переживают
изначальный: изначальным
вынести: вынести вынесли вынесла
крутой: круто круче
детально: детально
негатив: негатива
диагностический: диагностической диагностическом
логичный: логично логичным
пролить: пролила
слеза: слезах слез слезы
грустить: грустить грустит
выпасть: выпал
черёд: чередом
благодарный: благодарна
платить: платила
помощник: помощником
эволюция: эволюцию
свадьба: свадьбы свадьбе свадьбой
отчаяние: отчаяние
генетик: генетика
рейтинг: рейтинг
многофункциональный: многофункциональный
заразить: зараженную заразить
влажность: влажность влажности
длиться: длится длилось длиться
ослабевать: ослабевает
наравне: наравне
кюретаж: кюретаж
медиатор: медиатор
антидепрессант: антидепрессанты антидепрессантов антидепрессант
разрушение: разрушения разрушению разрушение
прибор: прибор приборы
подавать: подает подаем подающий
стопа: стоп стопа стопы стопе
маскировать: маскируют
мытьё: мытье мытья
йога: йогой йоги йогу йоге йога
зоопарк: зоопарках
бульон: бульон бульона
смазка: смазки смазку смазкой
тереть: тереть
босоногий: босоногая
оборудование: оборудование оборудования
даун: дауна
багажник: багажник
линза: линза линзами линзы
грязь: грязь грязи
портативный: портативный
очередной: очередное очередная очередной
луна: луны
висцеральный: висцеральный висцеральная
двоиться: двоится
ерунда: ерунда
ластик: ластик
огурец: огурцы огурцов
неспелый: неспелые
авокадо: авокадо
аппендикс: аппендикс
кран: крана
ломкий: ломкими
супермаркет: супермаркете супермаркетах супермаркет
коренной: коренные
полоскать: полоскать
кокосовый: кокосовый кокосовым кокосовое
морской: морских морской морские
походка: походка походки
красить: красить красящих красящие
ледяной: ледяной
шиповник: шиповник
разогреть: разогреть
север: север
ударить: ударили
пах: паха пах
многоступенчатый: многоступенчатый
пузырёк: пузырьки
мочевина: мочевина
уставать: устают устаете устает
курильщик: курильщики
улитка: улиток
коэнзим: коэнзим
аутоагрессия: аутоагрессия
токсичный: токсичный токсичен
сколиоз: сколиоз
виноградный: виноградных
очаг: очагом очаги
стрептоцид: стрептоцидом
протирать: протирают протирать
аминокислота: аминокислотами аминокислота
разгрузка: разгрузки
артроз: артрозе
плач: плачи плача
грыжа: грыжа грыжу
позвоночник: позвоночника позвоночник позвоночнике
подушка: подушки подушка подушке подушку
молочница: молочницы молочнице молочницу
массировать: массировать
уксус: уксус уксусом
мушка: мушки
гуща: гущу
травмировать: травмирует травмировать
аутистический: аутистического
бег: бегу беге бега
коррекция: коррекцию коррекция коррекции
мигрень: мигрень мигрени
профанация: профанация
магнитный: магнитные магнитного магнитно магнитным магнитными
фракция: фракции
оказать: оказать
поллиноз: поллиноза поллиноз
завтра: завтра
дефект: дефект
пихта: пихты
апоплексия: апоплексию
туберкулёз: туберкулез
увлажнитель: увлажнитель
гайморит: гайморит
межпозвоночный: межпозвоночную межпозвоночного
миопия: миопия миопией
кариес: кариеса кариесом
депиляция: депиляции
сода: сода соду
концерт: концерта
ненадолго: ненадолго
сотрясение: сотрясение сотрясения
купаться: купается
разбивать: разбивают
лопух: лопуха
солодка: солодки
цикорий: цикорий
загноиться: загноилась
вино: вино вина
коленный: коленные коленного
спираль: спираль
ехать: ехать
продаваться: продавались продаются
самомассаж: самомассаж
бронхит: бронхитом
серебрение: серебрение
тмин: тмина
баня: баню
остановить: остановить
мракобесие: мракобесие
щёлкать: щелкает
наушник: наушников наушники
паника: паники
висеть: висеть
запястье: запястье запястья
видимо: видимо
пряник: пряников
чеснок: чеснока чеснок
десяток: десятки десятком десятков
обед: обедом обеда
седло: седла
прожилка: прожилок
каблук: каблуках
вакцинация: вакцинации
пирсинг: пирсинг
индекс: индекс
виноград: виноград
куча: кучу
губка: губки
дельта: дельта
невролог: неврологи неврологом невролога невролог
ставить: ставить ставят ставит
какашка: какашки
пломба: пломба пломбы
трансфер: трансфер
чудной: чудное
твердить: твердят
обязательный: обязательна обязательно
эластичный: эластичный
очко: очков
пичкать: пичкают
эстрагон: эстрагон
мучиться: мучиться
гарь: гари
сливать: сливать
иммунитет: иммунитет иммунитета иммунитету
курорт: курортах курорте
блефарит: блефарит
диспепсия: диспепсии
вена: вены вен
металлический: металлические металлическими металлический
уверять: уверяют
тайский: тайского
погибать: погибают
варикоз: варикоз
некий: неким
езда: езда
велосипед: велосипеде
селезёнка: селезенки
зевать: зевает зеваем
цыплёнок: цыплят
деревня: деревне
жабра: жабрах
песок: песка
вздрагивать: вздрагиваю
прививка: прививки прививка
цистит: цистита цистит
куриный: куриные
быстрорастворимый: быстрорастворимые
надежда: надежда надежду
вытирать: вытирать
перебор: перебор
спутник: спутник спутником
комар: комара комары
коктейль: коктейли коктейль коктейле
чудесный: чудесно чудесная
силикон: силикон
попеременно: попеременно
наколенник: наколенник
сберечь: сберечь
бурый: бурым бурый
летать: летать
разбиться: разбился
градусник: градусник
халязион: халязион
побежать: побежать
туалет: туалете туалетов туалет
подниматься: подниматься
врать: врут врать
муха: мух
продажа: продаж продажа продаже
дешевле: дешевле
утренний: утреннем утреннего
выражение: выражением выражение
гипоплазия: гипоплазию
планка: планке
дорого: дорого
вплотную: вплотную
абрикос: абрикоса
креатин: креатин
прочесть: прочесть прочла
остеоартроз: остеоартроз
медь: медь медью меди
шпора: шпору
редька: редьки
кашель: кашля
прохладный: прохладным прохладном прохладную прохладные прохладного
птоз: птоза
пожарить: пожарить
обруч: обручем
перерасти: перерастут
варка: варки варке
нашатырь: нашатырь
левша: левшу
ячмень: ячмень
акклиматизация: акклиматизация акклиматизации
климат: климата
серёжка: сережки сережек
юный: юном юная
накапливать: накапливает накапливать накапливают
зажигать: зажигает зажигать
квартира: квартиры квартире
останавливаться: останавливаться останавливается
квас: кваса
дистрофия: дистрофии
сетчатка: сетчатки
хозяйственный: хозяйственным
лекарь: лекарь
ноздря: ноздри ноздрей
картина: картины картину картин картина
объесться: объесться
сын: сыну сыновьями сыновей сына сыном сын
наркоз: наркоз
переубедить: переубедить
вытащить: вытащить
ватрушка: ватрушке ватрушках
сломать: сломать
колет: колет
бок: боку
конъюнктивит: конъюнктивите
куркума: куркумы куркума
суп: суп
шишка: шишку шишка шишки шишек
пластырь: пластырь пластырем пластыря
черника: черника
обморок: обмороку обмороки
порок: порок
полоска: полоска полоски
пассивный: пассивное
приучить: приучить приучен
горшок: горшок горшку горшке
пальмовый: пальмовое
эндометриоз: эндометриоз
кружиться: кружится
анестезия: анестезия анестезии
перекись: перекись
водород: водорода
храп: храпом
пиво: пива
звонить: звонить
беспокойный: беспокойных
трясти: трясти трясет
опоясывать: опоясывающий
корректировать: корректировать
прибавить: прибавить
полететь: полетит
турецкий: турецкая
водородный: водородная
антицеллюлитный: антицеллюлитный
дождь: дождя дождь
прятать: прятать прячут
водоём: водоеме
трикотаж: трикотаж
проглотить: проглотить
ценный: ценно ценные ценный
перекусить: перекусить
канцероген: канцерогены
бросить: бросить
закладывать: закладывает
эпиляция: эпиляции
орбита: орбиты орбите
космонавт: космонавты космонавтов
томография: томография
сосед: соседями соседи
питомец: питомцев
атака: атак атаки атаках
лунатизм: лунатизм
папиллома: папилломы
диетический: диетических
мифический: мифических
термометр: термометр
сонный: сонном
тупик: тупик
неловко: неловко
педагог: педагогам педагог педагога педагогов педагоги
урок: урока урок уроке уроков уроки
прижиться: прижились
несчастливый: несчастливых
закрывать: закрывать закрывает
сцена: сценами сцену
инкогнито: инкогнито
дари: дари
ближний: ближнему
лот: лотов
сотрудник: сотрудников сотрудники
ёлка: елкой елку елки
милый: милы милых милый милыми милые
бесконечный: бесконечных
чуткий: чуткое
непростой: непростые непростой непросто
сойти: сойдет сойти
ум: ума
живопись: живопись
беседа: беседа
пальто: пальто
важность: важности важность
лично: лично
порой: порой
чепчик: чепчик
шарф: шарф
заместитель: заместитель
директор: директора директор
дед: дед деду
мороз: мороз морозам морозу мороза
билет: билеты
спектакль: спектакль
генеральный: генеральная генеральный
мастерский: мастерской
афиша: афише
абонемент: абонемента абонемент
грань: грани
фантастика: фантастики
кайт: кайт кайте
пылесос: пылесос
компактный: компактная
хозяин: хозяину
суметь: суметь сумела сумели
обожать: обожаю обожаем
грузинский: грузинского
вложение: вложением
инвестиция: инвестиция инвестиций
гостить: гостишь
виктория: виктория
настигать: настигает
тоска: тоска
девиза: девиза
покорить: покорили
серьга: серьги
дорожка: дорожки дорожках
украшать: украшаем
украсить: украсить украшен
кристалл: кристаллы
сверкать: сверкающей сверкать
попросту: попросту
всякий: всякие всякое
сотник: сотник
отдел: отдела отдел
поймать: поймала
футболка: футболкой футболка футболки футболок
базовый: базовые базовую базовой базового
гардероб: гардероба
встречать: встречаете встречала
декор: декор декором
цеплять: цепляли
доля: доля долей
адский: адскими
ад: ада
накопить: накопила
исправлять: исправляю
одарить: одарить
сертификат: сертификат
брошь: брошь
можжевельник: можжевельником
отель: отель отеля
партнёрство: партнерстве
бутон: бутон
шёлк: шелка шелк
украшение: украшений украшение украшения
сессия: сессии сессий
симпатичный: симпатична
палитра: палитра
времяпровождение: времяпровождения
лопатка: лопатки лопатка
ныть: ноет
тьма: тьму
комплект: комплект
настольный: настольных
эпоха: эпоху эпохи
ненависть: ненависти
двадцатый: двадцатого
прошлое: прошлом прошлое прошлого
майка: майка
потрясение: потрясением потрясений
кулик: кулик
гонка: гонке
окружить: окружить
уют: уют
чепец: чепец
стрижка: стрижки
просыпаться: просыпаться
планирование: планирование планировании
виниловый: виниловая виниловый виниловом
музыкальный: музыкальные музыкальных музыкальную музыкальный музыкальная музыкальной
лирика: лирикой
передержка: передержке
пёс: пес
приют: приютам приюту приюта
поначалу: поначалу
достаться: достался
хвостик: хвостики
менеджер: менеджер
залог: залог
атмосфера: атмосфера атмосферы
вдохновение: вдохновение
лавка: лавки лавок
перо: перьями
бойфренд: бойфрендом
двойной: двойная
коммерческий: коммерческое коммерческий
закончить: закончила закончив закончили
ремонт: ремонт
завершить: завершенным
гостиная: гостиной
шуба: шубе шубу шуба
архитектурный: архитектурной
дерзкий: дерзкое
леопард: леопарду леопарде
легализовать: легализована
городской: городской
сумасшедший: сумасшедшей
преданный: преданной
творчество: творчества
чекан: чекан
лид: лид
грандиозный: грандиозных
истинный: истинный
клан: клана
сопрано: сопрано
мотив: мотивам
обманывать: обманываю
дизайн: дизайном дизайна дизайн
бренный: бренном
художественный: художественный
оглянуться: оглянуться
бокал: бокалами бокал бокалов
отправиться: отправиться
капор: капоры капор
роскошно: роскошно
смотреться: смотреться смотрится
коктейльный: коктейльным
платье: платьем платье
червь: червя
трофей: трофеем
выходной: выходные
возвращение: возвращения возвращение
обрести: обрести обрел
висок: виски
практичный: практичного
балаклава: балаклавы балаклава
поместиться: поместится
контейнер: контейнер контейнера контейнере
кошачий: кошачьего
корм: корма
телепередача: телепередачи
меломан: меломаны
выдерживать: выдерживать
поп: поп попы
ваза: вазой вазу ваза
неповторимый: неповторимое
кладезь: кладезь
прошлый: прошлом прошлой прошлого
цивилизация: цивилизации
очертание: очертания
руина: руины
переосмыслять: переосмысляет
бонг: бонг
букет: букете букет букетом
эвкалипт: эвкалипта
пожелать: пожелать
пижама: пижама пижаму пижамы
лён: льна
проигрыватель: проигрывателе проигрыватель
кинотеатр: кинотеатр
залп: залпом
захватить: захватят захвати
килограмм: килограмм
приехать: приехала приехали
добраться: доберусь
пристально: пристально
лаконичный: лаконичные
рад: рада рады
прямоугольный: прямоугольным
бриллиант: бриллиантом
овальный: овальным
рубин: рубином
насекомое: насекомые
жук: жук жуки
поверить: поверил поверьте
прислать: пришлет пришлите прислать
передвижение: передвижения
презентация: презентации презентация
вечеринка: вечеринки вечеринках
самокат: самокат
проехать: проехать
подзарядка: подзарядки
скоростной: скоростных
агрегат: агрегат
сани: сани
везти: вез
лихо: лихо
завернуть: завернули
уд: удом уда
шалфей: шалфей
зелень: зелени зеленью
роза: розы роза
символ: символ символы
милосердие: милосердия
драйвер: драйвер
маскулинность: маскулинность
цветочный: цветочные
космический: космический космические
возрождение: возрождения
гроза: гроза
куст: куст
смородина: смородины
дача: даче
перенести: перенесли перенесут перенести
прилавок: прилавках
развал: развалах
чувственный: чувственных чувственную чувственное
премьера: премьера
мёрзнуть: мерзнете
меланхолия: меланхолия
канун: канун
лад: лад
офлайн: офлайн
галерея: галерея
пассаж: пассаж
красавица: красавице
свечка: свечку свечка свечке
воск: воском воска воск
ель: ели
сибирский: сибирских
еловый: еловых
фенхель: фенхеля
бубенчик: бубенчиком
вишенка: вишенкой
мелисса: мелиссой
огонёк: огонька
благоухание: благоухания
пахучий: пахучих
бутик: бутике
переулок: переулке
взглянуть: взгляните
карусель: карусель
поджечь: поджечь
катать: катает
олень: олень
лев: льва лев
слон: слона слон
лебедь: лебедь
нарисовать: нарисованы нарисовать нарисовано
кожица: кожицу
загореться: загорелся
правдоподобность: правдоподобность
спиртное: спиртного
приглядеться: приглядитесь
наутро: наутро
ликёр: ликера ликере
тег: теги
роман: романов романа
хвост: хвосты хвост
тугой: тугие тугой тугих
причёска: прически причесок прическе
облысение: облысению облысение
передохнуть: передохнуть
изредка: изредка
бигуди: бигуди
завивать: завивать
вымыть: вымыть
расчесать: расчесать
головка: головками
вырастать: вырастают
успевать: успевает
чешуйчатый: чешуйчатые
краска: краска краску
портиться: портятся
санаторий: санаторий
герметичный: герметичный
накрывать: накрывают
подогреть: подогретый
влажный: влажный влажной
недоумение: недоумение недоумения
бог: богу бога
чтить: чтит
пережиток: пережиток
научно: научно
гипертония: гипертонией
вылечиться: вылечиться
некролог: некрологов некролог
указание: указанием указаниям
духовный: духовных духовными духовную духовным духовные духовная
утилитарный: утилитарным
мусульманин: мусульман
регуляция: регуляции регуляцией
община: общины
дружеский: дружеских
позитивный: позитивное позитивного позитивном позитивная позитивную позитивный позитивных позитивной
светский: светском светских
наркомания: наркомании
христианский: христианской
христианин: христиан
буддист: буддисты
конфессия: конфессий конфессии
говориться: говорится
иудей: иудеев
протестант: протестантами
католик: католиками
еврейский: еврейских
топить: топить
католический: католических
сельский: сельской сельское
учение: учения
тоталитарный: тоталитарные
администратор: администратор администратором администратору
вышеуказанный: вышеуказанного
обращение: обращение обращения
свобода: свобод
неприкосновенность: неприкосновенность
частный: частную частной
конфиденциальный: конфиденциальных
охранять: охраняемую
извлечение: извлечение
организовать: организована организовать организующие
уничтожаться: уничтожаются
материальный: материальные
непосредственно: непосредственно
отправка: отправки
заходить: заходит заходить
правовой: правовому правовые
регламентация: регламентация
реализация: реализации реализация
внедрение: внедрения
закладка: закладок
вторжение: вторжений
предпосылка: предпосылки
размещаться: размещаться
подключить: подключенном подключит подключить
аннулировать: аннулировать
сервер: серверам
рамка: рамках рамки
тематика: тематике
единение: единение
пропаганда: пропагандой
пост: пост
ценз: ценз
развращать: развращает
осматривать: осматривать осматривает
ребята: ребята
публично: публично
счесть: счесть счел
интеллектуальный: интеллектуального интеллектуальная интеллектуальными
непонимание: непонимание
скрыть: скрыть скрытых
намерение: намерений
инициатор: инициаторами
типичный: типичные типичной типичных
рутина: рутину рутины рутина
карточка: карточек
помыть: помыв
публичный: публичные
боязнь: боязни боязнь
срочно: срочно
мерзкий: мерзкие
инцест: инцеста
реализовать: реализует
мыслить: мыслить мыслят
произнести: произнести
приучиться: приучиться
сесть: сесть сядет
купальник: купальника
заводить: заводят заводить
пресечь: пресечь
печенька: печеньку
голландский: голландские
отодвигать: отодвигать
плоть: плоть
поллюция: поллюции
комплексовать: комплексовать
проговорить: проговорить
классно: классно
звать: зовут
гость: гость гости гостях
замаскированный: замаскированные
секрет: секреты секретом
лгать: лгут
угрожать: угрожают
компетентность: компетентности компетентностью
обилие: обилия
эпитет: эпитетов эпитеты
махать: машет махать
посторонний: посторонним
чепуха: чепуха
опираться: опираемся опираться
статистик: статистики
педагогический: педагогических
конференция: конференциях
убеждать: убеждают
преподавать: преподавать
приглашать: приглашают
запутаться: запутался
латексный: латексные
кавалер: кавалер
пособие: пособия
некомфортный: некомфортно некомфортные некомфортное
продуктивный: продуктивным
доверие: доверие доверия
профилактический: профилактического профилактическим профилактическое профилактический
факультет: факультет
соискатель: соискателем
позвонить: позвонить
скрепка: скрепки
спальный: спальный
мешок: мешок
электричество: электричеству
генерировать: генерируют
двигаться: двигаемся двигается двигаться
банально: банально
действенно: действенно
температурный: температурной
попасться: попалось
шутка: шуток
мем: мемов
своеобразный: своеобразный своеобразным
мост: мостом
население: населением населения
вовсю: вовсю
школьник: школьники школьника школьников
опрашивать: опрашивали
закономерность: закономерности
ученик: учеников ученики
уменьшиться: уменьшился
молодёжь: молодежи молодежь
хлопотный: хлопотным
утомлять: утомляет
неясный: неясно
наследство: наследству
упрощать: упрощать
мышление: мышление мышлению
подогнать: подогнать
соционика: соционика
псевдонаука: псевдонаука
астрология: астрология
прикол: приколу
нейротизм: нейротизм
складываться: складываются
аббревиатура: аббревиатуру
дополнить: дополнил
факторный: факторному
метода: методу
балл: балла балл баллов баллы
охватить: охватить
замысел: замыслу
крайность: крайностями
посередине: посередине
заряжать: заряжает
немногословный: немногословные
неторопливый: неторопливые
дружелюбие: дружелюбием дружелюбие
добрый: добрые добрый
бескорыстный: бескорыстный
уникальность: уникальность
безразличный: безразличны
обязанность: обязанности
пунктуальный: пунктуальных
слабовольный: слабовольных
лидировать: лидирующие
низка: низкой
пессимистичный: пессимистичный
неустойчивый: неустойчивый неустойчивы
ранить: ранимый
сдержать: сдержаны
эстетичный: эстетичный
развитой: развитыми
хобби: хобби
противоположность: противоположности
консерватор: консерваторами
эмпирически: эмпирически
оспаривать: оспаривают оспаривали
критиковать: критиковать критиковали критикуют
должность: должность
мотивация: мотивацию
фирма: фирмы
наркоман: наркоман
умение: умений умения
сходиться: сходятся
окисление: окисления
эндопротез: эндопротеза
организатор: организаторов организатор
педиатрия: педиатрии
тироксин: тироксин
трийодтиронин: трийодтиронин
гипотиреоз: гипотиреоз
гипофиз: гипофизе
переносимость: переносимость
интерпретировать: интерпретирует интерпретировать
протон: протонов протоны
возврат: возврат
построить: построить
соседний: соседних
усиление: усилению
интерпретация: интерпретациям интерпретацией интерпретации интерпретацию интерпретация
скан: скана сканах сканы
расшифровка: расшифровка расшифровки
точность: точности точность
декодирование: декодирования
сюжет: сюжет
предназначение: предназначение
высокоточный: высокоточную
лучевой: лучевой лучевую
опухоль: опухоли
деталь: детали деталями
имплантировать: имплантированные
водитель: водители водитель
пейсмейкер: пейсмейкеры
протез: протезов
клаустрофобия: клаустрофобии
пространство: пространство пространстве пространств
металл: металл металла
изготовить: изготовленную изготовлен
волноваться: волноваться
делаться: делается
непредвиденный: непредвиденных
благополучно: благополучно
спирометрия: спирометрия
подозрительный: подозрительных
невооружённый: невооруженным
прозрачность: прозрачность прозрачности
освещение: освещение
последовательность: последовательность
осторожно: осторожно
колпачок: колпачки
кросс: кросс
плоскость: плоскости
выявлять: выявлять выявляет
взятие: взятие
образец: образцы образцов образца
карл: карл
самоанализ: самоанализу
раздумье: раздумьям
бодрый: бодрым бодрее
тишина: тишине
копировать: копирует
завоевать: завоевала завоевать
одобрение: одобрении одобрение
ложный: ложный
деление: деление
рефлексировать: рефлексирующую
уединение: уединения
экзамен: экзаменом экзаменам экзаменов
проявиться: проявиться
осудить: осудить осудят
дрожать: дрожит дрожащий
анализировать: анализируют анализирует
двойка: двойку
одноклассник: одноклассники
унижать: унижать
глупый: глупым
продумывать: продумывать
одиночество: одиночество одиночества
застенчивость: застенчивость
интроверсия: интроверсия
скучный: скучный
копиться: копятся
дефекация: дефекации дефекация дефекацию
жесть: жести
дистанция: дистанция
кал: кала кал
намеренный: намеренное намерен
позыв: позывы
сегмент: сегмент
сдерживаться: сдерживаться
командировка: командировках
вслед: вслед
застать: застали
врасплох: врасплох
сдвигаться: сдвигались
бодрствование: бодрствования
джетлаг: джетлаг
вылет: вылета
часовой: часовому
крутить: крутит
орёл: орла
унитаз: унитазе
опорожнение: опорожнения
охватывать: охватывает
таз: таз
петля: петля
присесть: присядешь
торопить: торопить
поработать: поработать
задерживать: задерживают
безрезультатно: безрезультатно
чистоплотность: чистоплотность
задний: заднего задней задний заднюю
проход: прохода
грусть: грусть
профессор: профессор
разрыв: разрывы разрывом разрыв разрыва
шестьдесят: шестьдесят
болевой: болевые
учесть: учесть
заедать: заедают
песня: песен песни
угроза: угрозу угрозой
бестактный: бестактный
мелочь: мелочь
превратить: превратить
драться: драться
ветвь: ветвь ветви
вегетативный: вегетативной
симпатический: симпатическая
мобилизация: мобилизация мобилизацией
проявить: проявит проявить
кулак: кулаки
гипоталамус: гипоталамус
пульс: пульс
активация: активации
стиснуть: стиснуть
закричать: закричать
верх: верх
эпизодически: эпизодически
плечо: плечом плечи плечо
метро: метро
поехать: поедет поехали
хамство: хамства
предательство: предательства
деспотичный: деспотичной
поощрять: поощряйте поощрять
оскорбление: оскорбления
дверь: дверь дверью
пнуть: пнуть
наружу: наружу
вдох: вдох
выдох: выдох
вялый: вялому
взвод: взводе
прилагать: прилагать
приседание: приседания
удалиться: удалиться
стена: стены
усугубить: усугубить
поссориться: поссориться
целостный: целостная
плавание: плавание плаванию плавания плаванием плавании
хамить: хамит
трамвай: трамвае
бесить: бесить бесит
лента: лента ленту
наименование: наименование
широко: широко
непроизвольный: непроизвольного
сокращение: сокращения сокращение
спастический: спастическая
офтальмолог: офтальмолог офтальмологом
джин: джин
потребовать: потребовала
складка: складки
улыбка: улыбка улыбку улыбкой улыбки
переносица: переносице
лапка: лапок
фальшивый: фальшивой
плато: плато
схожий: схожее
гримаса: гримасой
парадокс: парадокс
стереть: стереть
лоб: лба
посоветоваться: посоветоваться
виноватый: виноват
щекотка: щекотки щекотка щекоткой щекотку
ревность: ревности ревностью
высказывание: высказыванию
касание: касания
ползти: ползет полз
намеренно: намеренно
веселие: веселье
ножка: ножки
вероятно: вероятно
пощекотать: пощекотать
обмануть: обмануть
имитировать: имитируют имитирует имитировали
простор: просторах
доминировать: доминирующим
враждебность: враждебность
толстеть: толстеют
наряду: наряду
моносахарид: моносахаридов моносахариды
дисахарид: дисахарид дисахариды
сахароза: сахарозы сахароза
полисахарид: полисахариды
картофель: картофеле картофель
лишить: лишена лишить
топливо: топлива
расщепление: расщеплении
кетон: кетоны кетонов
преимущественно: преимущественно
возвращать: возвращать
хозяйство: хозяйство
мучной: мучные
подразумевать: подразумевает
нормализация: нормализации
откат: откаты
сознание: сознание сознания
сдвиг: сдвигу
калорийность: калорийности калорийность
забраться: забралась
коврик: коврике
вверх: вверх
наклонить: наклонив
должный: должное
соединиться: соединиться
образовать: образуют
толчок: толчки
снежный: снежный
ангел: ангел
ласкать: ласкать
тереться: тереться
располагаться: располагаются располагается
скользить: скользить
ворота: ворота
согнуть: согнуть
мостик: мостике
клип: клипа клип
королева: королевы королев
этика: этики
альбом: альбомом альбома альбом альбоме
страдание: страданий страдания
максималист: максималисты
всадник: всадники
победить: победил победить
телезвезда: телезвезду
механика: механика
критик: критики критик
лан: лане
рей: рей
композитор: композиторы композитор
глотка: глотке
яростный: яростные
цитата: цитаты
виолончель: виолончелью
вуду: вуду
мамочка: мамочки
авторство: авторства
весенний: весенней
поэтесса: поэтесса
роковой: роковая
сингл: сингла
дождаться: дождемся
ужасный: ужасен ужасного
музыкант: музыканты музыканта
копирайтер: копирайтер
библиотека: библиотеке библиотека
посетить: посетили посетить
примечание: примечание
кеш: кеш
ненадёжный: ненадежные
импортировать: импортировать
вспотеть: вспотеть вспотевшее
повезти: повезло
апокриновый: апокриновые
прибегнуть: прибегнуть
впадина: впадинах впадине
бросать: бросает
жар: жара жар
ангидроз: ангидроз
затрагивать: затрагивать
конечность: конечностях конечность конечности
выписывать: выписывают
навещать: навещают
похороны: похороны
небытие: небытие
мучить: мучает
ипохондрия: ипохондрией
ремень: ремнем
крокодил: крокодилом
осознание: осознание
задаваться: задаются задаваться
неплохой: неплохо
краткий: краткую краткое краткой
кладбище: кладбище
рассказ: рассказ
розетка: розеток
колонка: колонок
разрушить: разрушит разрушить
гипотетический: гипотетической
головокружение: головокружения головокружение
рецидив: рецидивов
визуализировать: визуализировать
надгробие: надгробия надгробий
запомниться: запомниться
искажение: искажения
неопределённость: неопределенность
архив: архив архива
незамысловатый: незамысловатым
догадаться: догадались
сокровище: сокровища
кадр: кадров
отрывок: отрывки отрывков отрывок
режиссёр: режиссера режиссер
демонстративно: демонстративно
приезжать: приезжала
площадка: площадку площадке
шлепок: шлепки
восстать: восстать
общепринятый: общепринятых
двор: двор дворе
сборник: сборник
поэзия: поэзия поэзии
художница: художницей
рисовать: рисовать рисовали
напечатать: напечатанные
фотограф: фотографом
семиклассница: семикласснице
школьный: школьной
жутко: жутко
самоубийца: самоубийц самоубийцы
мрачный: мрачную
драма: драму драма
продюсер: продюсер продюсеры продюсерам
вечность: вечность
хорошенький: хорошенькой
блондинка: блондинке
скрываться: скрывалось
съёмочный: съемочной
слева: слева
блокнот: блокнотов
кинофестиваль: кинофестивале
справа: справа
очаровательный: очаровательная
заразительный: заразительный
копия: копия
очутиться: очутилась
элитный: элитного
выдать: выдала
пустить: пустила
свалить: сваленной
икона: икона
придумать: придумать придумал
одеваться: одеваться
мемуары: мемуары мемуаров
рококо: рококо
пистолет: пистолетами
суппозиторий: суппозиториев
упоминаться: упоминается
антибактериальный: антибактериальный антибактериальная
заряд: зарядах
мембрана: мембраны мембраной
утечка: утечке
содержимое: содержимое содержимого
микоз: микозов
сифилис: сифилиса
гонорея: гонорея гонореи
микроб: микробов
альтернатива: альтернатива альтернативами альтернативой альтернативы
потенциал: потенциалом
опорный: опорно
двигательный: двигательный
инцидент: инцидента
заминка: заминки заминку
неподходящий: неподходящего
сухожилие: сухожилие
соединять: соединяет
голень: голень голени
ступня: ступню
локтевой: локтевой
многократный: многократных
теннис: теннис
мениск: мениска
специфика: специфика
одновременный: одновременная
гимнастика: гимнастика
акробатика: акробатика
батут: батуте
скейт: скейт
мотокросс: мотокросс
фехтование: фехтование
метание: метание
копьё: копья
гребля: гребля
каноэ: каноэ
футбол: футбол
гандбол: гандбол
баскетбол: баскетбол
бокс: бокс
синхронно: синхронно
скалолазание: скалолазание
вдвое: вдвое
медленно: медленно
аудиокнига: аудиокниги
неправильно: неправильно
смещение: смещение
скрежет: скрежет
треск: треск
хлопок: хлопки
подозревать: подозреваете
иммобилизация: иммобилизация
повязка: повязка
шина: шина
рецептурный: рецептурных
связка: связок
шов: швы шов
серый: серый
временный: временный
безобидный: безобидным
лук: лук лука
спаржа: спаржи спаржа
покинуть: покинут
уретра: уретру
никотин: никотина никотин
желтуха: желтуха
билирубин: билирубин
паниковать: паникуйте
финансы: финансы
забронировать: забронировать
кошелёк: кошелек
студия: студию студия
камера: камеру камера камерой
поставщик: поставщиком поставщиков
сейф: сейф
дисплей: дисплей
подробность: подробности подробностей
сбой: сбои сбоям сбоях
мониторинг: мониторинга
препятствовать: препятствуют
целиакия: целиакия
гомеостаз: гомеостаза
жалоба: жалобы жалоб
фундук: фундук
тыква: тыква
злак: злаки
овсянка: овсянка
рис: рис
фасоль: фасоль
нут: нут
соя: соя
горох: горох
растворяться: растворяться
очистка: очистка
зародыш: зародыши
промышленность: промышленность промышленности
усилитель: усилителей
разнообразно: разнообразно
аграрный: аграрного
удобрение: удобрений
котик: котиками
кот: кота
рекорд: рекордов
напрасный: напрасная
растяжимый: растяжимое
котёнок: котят
аффект: аффекте аффект аффекта
наблюдательный: наблюдательные
студент: студентам студентах студентов студенты
сумчатый: сумчатыми
прокрастинация: прокрастинации прокрастинация
миссия: миссия
экосистема: экосистема
ежемесячно: ежемесячно
аудитория: аудитории
топ: топ
небезопасный: небезопасных
иллюстратор: иллюстратор иллюстраторы
командный: командной
идейный: идейный
вдохновитель: вдохновитель
руководитель: руководитель
репутация: репутации
заявка: заявки заявку
сотрудничество: сотрудничество сотрудничестве сотрудничества
энтузиазм: энтузиазмом
дочь: дочь дочери дочерью
героиня: героине героиня
превращаться: превращается
панда: панду
двенадцать: двенадцать
заход: заходов
честный: честный
покидать: покидают
испачкать: испачкать испачкали
познавательный: познавательные
комикс: комиксы комикс
дочка: дочке дочкой
ванная: ванной
простыть: простыла
расцвести: расцвел
пион: пион
перегружать: перегружать
терпеливый: терпеливы
располагать: располагает
колготки: колготки
химия: химии химия
нагнетать: нагнетайте
делегировать: делегировать
видеоролик: видеороликам
поясница: пояснице поясницу
плавать: плавать плавает
лишать: лишают
синтетический: синтетический синтетическом
размножаться: размножаются
неожиданно: неожиданно
качели: качелей
подальше: подальше
молчание: молчания
лепет: лепет
неумолимый: неумолимы
сообразительный: сообразительнее
баба: баба
кака: кака
полугодовалый: полугодовалый
ворковать: ворковать
бормотать: бормотать
прощание: прощание прощанием
непосредственный: непосредственного
гнусавый: гнусавый
горизонт: горизонты
афазия: афазия
уздечка: уздечка
двигать: двигать
депривация: депривация
расчёт: расчет
языковой: языковыми языковых
пи: пи
кивание: киванием
жестикуляция: жестикуляцией
подражание: подражании
ма: ма
ба: ба
издавать: издают издает
хлопать: хлопать
ладоши: ладоши
купать: купаете
одевать: одеваете
лестница: лестнице
любопытство: любопытство
неприязнь: неприязнь
покакать: покакал
пописать: пописал
усидчивость: усидчивость
памперс: памперс
флирт: флирте
неверно: неверно
холодность: холодность
нимфомания: нимфомании
заинтересованность: заинтересованность
мораль: морали
брачный: брачную
гармония: гармонии
проститутка: проститутками
фригидный: фригидными фригидные фригидная
концепция: концепцию
выдумка: выдумкой
словарь: словарей
разжигание: разжигание разжиганием
выгода: выгоду
убедить: убедить
торговец: торговцы
корреспондент: корреспондент
алан: алана
аргумент: аргументы
собрание: собрания
серьёзность: серьезность
прибыль: прибыль прибыли
институт: институты институт института
активист: активистов
разоблачать: разоблачают
энд: энд
пятый: пятая
подать: подать
изначально: изначально
слушание: слушании
корпорация: корпорации
вклад: вклад
грубо: грубо
пьяный: пьяным
дурак: дурак
бабочка: бабочек
суждение: суждением
совершение: совершение
телефонный: телефонных
разум: разум разуму
отвергнуть: отвергнут
изнурительный: изнурительным
весть: вести
приоритет: приоритеты
устанавливать: устанавливать
здороваться: здороваться
комплимент: комплимент
расспрашивать: расспрашивать
внука: внуках
глоссарий: глоссарий
пользование: пользования
скачать: скачать
лояльность: лояльности
вакансия: вакансии
анализатор: анализатор анализатором
чугунный: чугунной
батарея: батареи
основоположник: основоположник
жанр: жанра
полвека: полвека
масштабный: масштабную
фланкёр: фланкеров
коллекционный: коллекционных
произведение: произведение
огненный: огненным
всполох: всполохом
естественно: естественно
борец: борцы
знаток: знатоки
торговля: торговля
китаец: китайцам
ратовать: ратующие
даль: даль
дракон: дракону
нрав: нрав
ремейк: ремейк
узнаваемый: узнаваемым
замес: замес
смола: смол
толк: толка
вернисаж: вернисаж
ящик: ящик
беда: беды
ландшафт: ландшафт ландшафта
разумеется: разумеется
конкурент: конкуренту
элегантный: элегантной элегантным
парижский: парижской
кузина: кузины
опиум: опиума
обжигать: обжигает обжигающий
мимоза: мимозы
юность: юностью
невинный: невинной
ванильный: ванильно
неоднозначный: неоднозначные
уложить: уложить
козырь: козырем
игрок: игрок
обнажённый: обнаженной
сомневаться: сомневаться
постсоветский: постсоветских
старт: старте старт
здравствовать: здравствуйте здравствует
миниатюрный: миниатюрного
дальний: дальних
соблазн: соблазн
заскочить: заскочили
ужин: ужин
оркестр: оркестр
лакричник: лакричника
судьба: судьбе
бренность: бренности
сущий: сущего
тысячелетие: тысячелетии
ниша: нишей
люкс: люксом
выходец: выходцев
запад: запада
колыбель: колыбели
одиннадцатый: одиннадцатый
воспевать: воспевает
убежище: убежищем
берег: берегов
вершина: вершин
покрыть: покрытые покрытых
подложка: подложке
пирамида: пирамиды
конструкция: конструкции
веранда: веранде
летний: летним летнее
перелистывать: перелистывая
одуванчик: одуванчиков
досуг: досуга
состоятельный: состоятельных
господин: господ
занятой: занятому
прерваться: прерваться
бариста: бариста
щедрый: щедрой
француз: французом
амбициозный: амбициозным
шафран: шафран
удачно: удачно
замша: замши
куртка: куртка
ужинать: ужинали
вчера: вчера
знаменитый: знаменитого
набрасывать: набрасывает
пелерина: пелерину
мирра: мирры
лакричный: лакричное
добротный: добротный
бестселлер: бестселлером
утопить: утопила
ладан: ладана ладан
бабушкин: бабушкиного
проделка: проделки
пережидать: пережидали
осязать: осязаемый
отогреть: отогреть
квинтэссенция: квинтэссенция
осенний: осенних осенний
северный: северных
широта: широтах широте
прелый: прелой
древесина: древесиной
неминуемый: неминуемых
намёк: намеком намека
томный: томную
расходиться: расходятся
колкий: колким
сентябрьский: сентябрьское
бардак: бардак
пушистый: пушистыми
объёмный: объемный объемных
послушный: послушных
спойлер: спойлеры
адвент: адвент
эстет: эстетов
бальза: бальзам
карандаш: карандаш
незаметно: незаметно
недостающий: недостающее
невеста: невесты
беспроигрышный: беспроигрышных
фаворит: фавориты фаворит
осьминог: осьминог
шипящий: шипящая
пенка: пенка пенкой
визажист: визажист
локон: локоны
доехать: доехал
пятница: пятница
кома: комы
выдержать: выдержит
кокос: кокосом
полагаться: полагаться
греча: греча гречи гречу
лапша: лапши
марганец: марганец
селен: селен
покорять: покоряют
ковровый: ковровые
поджидать: поджидать
поблагодарить: поблагодарить
виток: виток
корейский: корейских корейским корейского
вооружение: вооружение
пак: пак
ник: ником
вдохновить: вдохновленные
субстанция: субстанциями
совпасть: совпал
носка: носки
воля: волю
видный: видна видны
френч: френч
абстрактный: абстрактные
мазок: мазки
хром: хром
цветной: цветные
код: кодом кодов
вау: вау
коса: косе кос
безумно: безумно
живучий: живучей
сволочь: сволочью
дядя: дядя
вест: вест
сказка: сказки
бублик: бублик
прихожая: прихожая
фейерверк: фейерверками
тапка: тапках
константа: константой
поэт: поэте
любовник: любовник
предсказание: предсказание
принц: принца
свастика: свастика
треугольник: треугольник
лауреат: лауреат
маньяк: маньяки
танцевать: танцующие
голый: голые
опека: опеку
какао: какао
облик: облик облике
аммиак: аммиака
обуславливать: обуславливают
сульфаниламид: сульфаниламиды
своевременно: своевременно
утолять: утолять
заболеваемость: заболеваемости
пловец: пловцов пловца
вводный: вводного
инструктаж: инструктаж
опытный: опытный
владеть: владеет
конь: коня
неестественный: неестественном
градус: градусов
дежурить: дежурит
вытаскивать: вытаскивать
откачивать: откачивать
удостоверение: удостоверением
крест: креста
исходный: исходный
загнать: загнать
прогресс: прогресс
расстояние: расстояние
соревнование: соревнованиях соревнованием
глухонемой: глухонемого
баловаться: балуются
пилот: пилот
корабль: корабля
плыть: плывет
протеин: протеин
гуглить: гуглить
ересь: ересь
периодичность: периодичность
столь: столь
следовательно: следовательно
понемногу: понемногу
чемпион: чемпионом
сахарин: сахарин
поступок: поступки
распадаться: распадается
метанол: метанол метанола
арахис: арахисе
смертельный: смертельная
итого: итого
гипертрофия: гипертрофии
формула: формула
зал: зала зал зале
бегать: бегать
приблизительно: приблизительно
остановиться: остановится
невежество: невежество
прекрасно: прекрасно
холодильник: холодильника
худой: худых
колика: колику
внезапный: внезапной внезапную внезапных
бронирование: бронирований бронировании
аренда: аренде
гостиница: гостиницах
рейс: рейсы
выключить: выключить
показываться: показывались
флажок: флажок
карты: карты
бронировать: бронировать
транспортный: транспортного
координата: координаты
долгота: долготе
столик: столик
жрец: жрецами
паллиативный: паллиативной паллиативная
служитель: служитель
священнослужитель: священнослужитель священнослужителю
священник: священником священника священник
умиротворение: умиротворения
коалиция: коалиция
армейский: армейская
крещение: крещение
причастие: причастие
соборование: соборование
православный: православные
исцелить: исцелит
обидеть: обижен
недоступный: недоступна
скачивание: скачивание
колясочник: колясочников
экстренный: экстренной экстренные
наводнение: наводнений
здание: зданий
отображение: отображение
масштаб: масштаба
вкладка: вкладка
атрибут: атрибутах
маркер: маркера
состязание: состязании
выключать: выключать
связанный: связанными
бета: бета
устранить: устранить
прибытие: прибытии
руль: рулем
электромобиль: электромобиль
дуэт: дуэта
гений: гениев
бах: баха
перспективный: перспективные
артист: артистам артистов
бит: бит
як: як
междометие: междометия
пермь: перми
петь: пели петь
плясать: плясали
уехать: уехавшие
вечный: вечном
электронщик: электронщиков
донна: донна
электроника: электронике
диджей: диджея
техно: техно
фестиваль: фестивали
туфля: туфель
дирижёр: дирижер
шалость: шалостях
властелин: властелин
театр: театров
шоу: шоу
ужас: ужасе ужас
артикул: артикул
упаковывать: упаковываем
партия: партию партии
обгореть: обгорела
сожалеть: сожалеем
личико: личико
чувствоваться: чувствуется
продукция: продукции
гражданин: граждане
белила: белила
огород: огорода
гейша: гейша
ассортимент: ассортименте ассортименту
калашников: калашникова
приятно: приятно
юг: юге
забить: забил
выстилать: выстилает
медикаментозный: медикаментозное медикаментозную
останавливать: останавливают
разрез: разрез
ангина: ангина
кардиолог: кардиологом
ревматолог: ревматологи
шаманизм: шаманизма
прививать: прививать
заглядывать: заглядываем
проктолог: проктологом
шпагат: шпагат
патологоанатом: патологоанатомы
пояснять: поясняем
кукушка: кукушку
растить: растить
новшество: новшества
равноценный: равноценными равноценных равноценные
трудовой: трудовых трудовым трудовой
заявление: заявлениям
коллективный: коллективным
нормативный: нормативно
согласование: согласованию
предупреждение: предупреждения
выплатить: выплатить
работодатель: работодателя
гражданский: гражданский
уголовный: уголовно уголовный
ук: ук
арбитражный: арбитражный
налог: налогах
имущество: имущество
полиция: полиции
бухгалтер: бухгалтера
рэпер: рэпером
использованный: использованный
позвать: позвала
налить: налил налить
заволноваться: заволновался
дожидаться: дожидаться
засыхать: засыхает
жгучий: жгучего
помёт: помета
кок: кока коках
кола: колой колы
американка: американки
буррито: буррито
убийство: убийством
чисто: чисто
двое: двоих
бессрочно: бессрочно
супруг: супругу
полезность: полезность
токсикология: токсикологии
допинг: допинг
географический: географическим
числовой: числовые
кобальт: кобальта
решающий: решающее
проба: проб
крупномасштабный: крупномасштабные
чат: чат чатах
оптом: оптом
выгодный: выгодных
розничный: розничных
закупка: закупок
гештальт: гештальт
сбербанк: сбербанк
распечатать: распечатать
отныне: отныне
экологически: экологически
утрата: утрата утраты утрату
оцепенение: оцепенение
ступень: ступени
росс: росс
умирание: умирании
отрицание: отрицания отрицание
отвергать: отвергает
выстраиваться: выстраиваться
беспомощность: беспомощности
пассивно: пассивно
смириться: смириться
утешение: утешение
включаться: включаясь
зависнуть: зависнуть
упадок: упадок упадком
приспособиться: приспособиться
выдохнуть: выдохнуть
умерший: умершему
преобладать: преобладает
горевать: горюющий горюющим
превалировать: превалирует
годовщина: годовщина
постепенный: постепенное
быт: быт
причитание: причитания
осмысливать: осмысливать
ощутить: ощутить
стабилизировать: стабилизировать
туча: тучи
светить: светит
доставать: доставать
произвести: произведен
надпись: надпись
стойкость: стойкость
пожертвовать: пожертвовать
аэрозоль: аэрозоли аэрозолей
смазать: смазать
равномерно: равномерно
затекать: затекать
прогноз: прогнозом
среднестатистический: среднестатистического
горка: горка
монета: монету
аналогий: аналогий
посчитать: посчитать
тюбик: тюбик
пачкать: пачкать
линейный: линейной
бутерброд: бутерброд
пористый: пористая
желательно: желательно
разниться: разнятся
загвоздка: загвоздка
масляный: масляной
водный: водной
автозагар: автозагар
изъять: изъять
прерывание: прерывании
шейка: шейку
преследовать: преследует
слияние: слияния
спускаться: спускается
шестой: шестой
пробирка: пробирке
жизнеспособный: жизнеспособный жизнеспособных
резервуар: резервуары
азот: азотом
прервать: прервать
ненужный: ненужными
ларингит: ларингитом ларингите ларингита
гортань: гортани
аконит: аконит
многолетний: многолетнее
обитатель: обитателей
белладонна: белладонна
семейство: семейства
паслёновый: пасленовых
язва: язв
измельчить: измельченных
раковина: раковин
тополь: тополь
двояковыпуклый: двояковыпуклые
ограниченный: ограниченное
эстрадиол: эстрадиол
новообразование: новообразования
ухудшение: ухудшению
безуспешный: безуспешны
стероидный: стероидных
повыситься: повысился
